Date,Hour,Commune Montreuil,IRIS 930480204,IRIS 930480205,IRIS 930480206,IRIS 930480401,IRIS 930480604,Total
2020-08-24,00:00:00,100209,9885,11802,8783,2893,9076,142648
2020-08-24,00:30:00,95213,11148,12184,8286,2895,9034,138760
2020-08-24,01:00:00,85383,9647,9769,6320,1681,8104,120904
2020-08-24,01:30:00,79010,6530,12188,6967,2413,8333,115441
2020-08-24,02:00:00,74321,7071,12501,5720,2812,1696,104121
2020-08-24,02:30:00,72135,7320,13194,5517,3039,1430,102635
2020-08-24,03:00:00,71303,6902,13416,6355,3047,1427,102450
2020-08-24,03:30:00,68022,7376,13309,5892,2641,1335,98575
2020-08-24,04:00:00,64955,6898,12983,7172,2942,1213,96163
2020-08-24,04:30:00,63763,2777,8483,7328,1992,1225,85568
2020-08-24,05:00:00,64204,2381,8401,7242,1653,1211,85092
2020-08-24,05:30:00,66468,1996,8306,7322,1592,1588,87272
2020-08-24,06:00:00,66366,2452,9471,8393,1790,1560,90032
2020-08-24,06:30:00,78528,6978,9893,7535,1725,5302,109961
2020-08-24,07:00:00,80863,7531,8902,6257,1803,6102,111458
2020-08-24,07:30:00,82234,7583,8971,7099,1638,7312,114837
2020-08-24,08:00:00,87078,8479,9874,6891,2222,7598,122142
2020-08-24,08:30:00,93208,10347,11455,8980,3036,9906,136932
2020-08-24,09:00:00,97840,11082,12178,10313,3163,10782,145358
2020-08-24,09:30:00,100328,12054,14263,11116,3397,11765,152923
2020-08-24,10:00:00,100402,10290,13061,9779,3134,10031,146697
2020-08-24,10:30:00,99190,10299,12370,8477,2846,10057,143239
2020-08-24,11:00:00,100388,11398,12873,9280,2765,11345,148049
2020-08-24,11:30:00,103650,11564,14271,10711,3218,11918,155332
2020-08-24,12:00:00,104562,11935,14100,10464,4120,11437,156618
2020-08-24,12:30:00,110030,12313,14726,11522,3943,12810,165344
2020-08-24,13:00:00,98037,12145,14472,10671,3514,11266,150105
2020-08-24,13:30:00,110033,12801,16138,12983,3737,13978,169670
2020-08-24,14:00:00,110401,12452,16257,13203,3340,14153,169806
2020-08-24,14:30:00,110046,13269,15836,11836,3907,13361,168255
2020-08-24,15:00:00,110742,13713,15682,12333,3831,13737,170038
2020-08-24,15:30:00,110169,12784,15622,12221,3646,14454,168896
2020-08-24,16:00:00,110703,12990,15239,12407,4733,13886,169958
2020-08-24,16:30:00,108168,12493,15850,11868,3767,13122,165268
2020-08-24,17:00:00,108894,12664,15330,11302,3341,13182,164713
2020-08-24,17:30:00,112963,13062,16297,12281,3502,14096,172201
2020-08-24,18:00:00,117033,13461,17265,13261,3664,15011,179695
2020-08-24,18:30:00,112027,14174,20456,14221,4310,15057,180245
2020-08-24,19:00:00,115463,15274,21502,14791,5225,15249,187504
2020-08-24,19:30:00,111111,13475,17287,13363,3549,14544,173329
2020-08-24,20:00:00,99809,10028,15559,12395,4172,13042,155005
2020-08-24,20:30:00,127742,14936,21237,13335,4501,17722,199473
2020-08-24,21:00:00,123105,14769,19687,15907,4366,13258,191092
2020-08-24,21:30:00,112508,13978,18327,13428,5153,14885,178279
2020-08-24,22:00:00,107079,13145,15327,11740,4471,12975,164737
2020-08-24,22:30:00,101087,12954,14814,10309,4988,11337,155489
2020-08-24,23:00:00,100048,12654,14970,9718,5312,9932,152634
2020-08-24,23:30:00,100017,11720,13514,9290,4385,10364,149290
2020-08-25,00:00:00,101381,10808,11683,8634,3848,9017,145371
2020-08-25,00:30:00,91141,11343,12183,8091,3345,9186,135289
2020-08-25,01:00:00,82507,10140,8649,5455,1959,8764,117474
2020-08-25,01:30:00,78826,8597,8641,5880,2001,6954,110899
2020-08-25,02:00:00,76428,8430,8402,6125,2800,4245,106430
2020-08-25,02:30:00,71038,9057,8201,5944,3220,876,98336
2020-08-25,03:00:00,69985,9501,7567,5562,3152,858,96625
2020-08-25,03:30:00,68501,8942,7917,5722,2976,846,94904
2020-08-25,04:00:00,66851,8523,7979,6339,2399,680,92771
2020-08-25,04:30:00,63841,6598,10022,7570,3093,1343,92467
2020-08-25,05:00:00,61529,3132,10260,7544,3366,1287,87118
2020-08-25,05:30:00,63941,2874,10793,8092,3484,1510,90694
2020-08-25,06:00:00,65358,2820,10503,8262,2927,1785,91655
2020-08-25,06:30:00,80197,8381,10178,6983,2365,5313,113417
2020-08-25,07:00:00,83363,8343,9107,7044,2061,6064,115982
2020-08-25,07:30:00,85699,8356,10034,6810,2319,6352,119570
2020-08-25,08:00:00,90939,9234,11863,8496,1957,7807,130296
2020-08-25,08:30:00,97189,10656,12241,9106,3644,8984,141820
2020-08-25,09:00:00,102197,10751,13413,10236,3266,11082,150945
2020-08-25,09:30:00,106852,11563,13814,8999,4192,10614,156034
2020-08-25,10:00:00,105507,11543,13647,8824,4337,10416,154274
2020-08-25,10:30:00,103718,11283,14578,9274,3302,10791,152946
2020-08-25,11:00:00,102742,10155,14285,9141,3940,10906,151169
2020-08-25,11:30:00,101774,10813,13221,9169,3738,10604,149319
2020-08-25,12:00:00,106383,10972,13856,9617,3192,10515,154535
2020-08-25,12:30:00,103983,11723,14997,10372,3452,11560,156087
2020-08-25,13:00:00,108812,13209,16115,12277,3685,12457,166555
2020-08-25,13:30:00,109536,12968,14665,10574,4427,11012,163182
2020-08-25,14:00:00,108764,13481,15902,10602,4122,10913,163784
2020-08-25,14:30:00,105258,11979,14491,10380,3932,11099,157139
2020-08-25,15:00:00,104670,11786,14534,10622,3672,10927,156211
2020-08-25,15:30:00,103570,12016,14549,10200,3627,11152,155114
2020-08-25,16:00:00,99197,12474,15239,9825,3131,11152,151018
2020-08-25,16:30:00,97468,12748,15442,11423,4073,9854,151008
2020-08-25,17:00:00,104959,12069,15764,11400,3622,12360,160174
2020-08-25,17:30:00,109194,12208,17307,13480,4563,14236,170988
2020-08-25,18:00:00,104247,13329,15770,12192,4142,13590,163270
2020-08-25,18:30:00,109190,13475,16877,12932,4465,14020,170959
2020-08-25,19:00:00,117368,14644,18910,15450,4907,16222,187501
2020-08-25,19:30:00,118440,15017,17404,14956,4761,14511,185089
2020-08-25,20:00:00,118470,14759,19387,15907,4167,13631,186321
2020-08-25,20:30:00,123873,14948,18891,14834,4973,16839,194358
2020-08-25,21:00:00,113284,14839,19088,14646,4265,15324,181446
2020-08-25,21:30:00,109584,14651,18989,13624,5013,14361,176222
2020-08-25,22:00:00,108601,13654,15184,12640,4643,12187,166909
2020-08-25,22:30:00,107612,14244,14415,9962,4718,12119,163070
2020-08-25,23:00:00,107231,13306,14265,9633,3765,10044,158244
2020-08-25,23:30:00,106275,12220,15176,9536,4222,10062,157491
2020-08-26,00:00:00,100232,11562,13738,8895,2846,9883,147156
2020-08-26,00:30:00,98940,11333,12179,8620,2788,10234,144094
2020-08-26,01:00:00,90685,9768,10051,7332,1781,8883,128500
2020-08-26,01:30:00,87178,9657,10340,6473,1772,8164,123584
2020-08-26,02:00:00,81681,9935,7162,4923,2540,8524,114765
2020-08-26,02:30:00,78064,12471,7944,5544,2331,5146,111500
2020-08-26,03:00:00,76254,12919,8198,4706,2406,5483,109966
2020-08-26,03:30:00,66728,7876,8691,5480,2709,4648,96132
2020-08-26,04:00:00,66258,7962,8768,5339,2243,828,91398
2020-08-26,04:30:00,68286,7494,8886,5857,2593,773,93889
2020-08-26,05:00:00,69678,7046,8320,5799,2286,761,93890
2020-08-26,05:30:00,68540,7718,8494,5855,2307,828,93742
2020-08-26,06:00:00,66999,8066,7787,6233,1173,1036,91294
2020-08-26,06:30:00,82987,8383,9546,6762,1399,5287,114364
2020-08-26,07:00:00,84610,7541,9135,6603,1432,6153,115474
2020-08-26,07:30:00,86696,7863,9414,6899,1580,6957,119409
2020-08-26,08:00:00,94027,8759,10482,8255,1828,8549,131900
2020-08-26,08:30:00,98572,9391,11693,9594,2333,10474,142057
2020-08-26,09:00:00,104135,10187,11982,9873,3241,11758,151176
2020-08-26,09:30:00,103224,11952,13222,9858,3533,11982,153771
2020-08-26,10:00:00,105046,11641,12876,9366,2598,11581,153108
2020-08-26,10:30:00,101404,12590,12274,8614,2994,10890,148766
2020-08-26,11:00:00,102976,11662,13634,9286,3124,11237,151919
2020-08-26,11:30:00,105684,12071,14538,10367,3904,12186,158750
2020-08-26,12:00:00,103972,11853,14849,10218,3730,12199,156821
2020-08-26,12:30:00,106296,12819,15211,11329,3351,12996,162002
2020-08-26,13:00:00,106052,13201,16125,11594,3610,12804,163386
2020-08-26,13:30:00,111105,14203,16214,11422,3970,12276,169190
2020-08-26,14:00:00,109072,13036,15771,10888,3823,11974,164564
2020-08-26,14:30:00,107506,12242,15148,10340,3591,12716,161543
2020-08-26,15:00:00,106501,12321,15232,10078,3778,12324,160234
2020-08-26,15:30:00,108467,12274,15687,11840,3743,13051,165062
2020-08-26,16:00:00,106774,12206,15052,11423,4475,12982,162912
2020-08-26,16:30:00,106858,12241,15393,12487,4113,13261,164353
2020-08-26,17:00:00,110134,12465,15232,11812,4495,13623,167761
2020-08-26,17:30:00,106122,13860,17135,13814,4845,14614,170390
2020-08-26,18:00:00,108457,12956,16436,12712,3651,13761,167973
2020-08-26,18:30:00,107622,13344,17248,13905,4208,14994,171321
2020-08-26,19:00:00,111089,14310,17191,14889,3750,14291,175520
2020-08-26,19:30:00,108906,12630,16679,14104,3408,13921,169648
2020-08-26,20:00:00,109120,12589,17883,14809,4533,13759,172693
2020-08-26,20:30:00,109313,12987,16859,13080,4500,13027,169766
2020-08-26,21:00:00,106939,12043,15771,12189,4289,12113,163344
2020-08-26,21:30:00,105561,13416,15210,11624,3729,11176,160716
2020-08-26,22:00:00,103393,12754,13729,10634,3145,10966,154621
2020-08-26,22:30:00,102031,11090,13248,9656,3932,9488,149445
2020-08-26,23:00:00,105198,11671,13397,9185,4230,9784,153465
2020-08-26,23:30:00,103526,12057,13272,9079,3280,9980,151194
2020-08-27,00:00:00,101374,11924,12300,8070,3355,8864,145887
2020-08-27,00:30:00,99101,11361,13675,8196,4400,8835,145568
2020-08-27,01:00:00,90340,9334,11217,5206,2182,7756,126035
2020-08-27,01:30:00,86265,6537,11893,4961,1727,6969,118352
2020-08-27,02:00:00,82856,5623,11614,5309,1916,6751,114069
2020-08-27,02:30:00,75748,7314,13464,5529,2565,4596,109216
2020-08-27,03:00:00,73047,7470,13427,5453,2623,875,102895
2020-08-27,03:30:00,72140,6950,12419,5325,2279,974,100087
2020-08-27,04:00:00,67294,7127,12519,6188,858,897,94883
2020-08-27,04:30:00,61855,6752,11867,5794,872,789,87929
2020-08-27,05:00:00,60229,7342,12380,5989,1422,726,88088
2020-08-27,05:30:00,62305,7030,11882,6044,1094,613,88968
2020-08-27,06:00:00,62995,7043,12651,6693,891,1051,91324
2020-08-27,06:30:00,81524,8055,10843,7036,1385,5444,114287
2020-08-27,07:00:00,84510,6930,8814,6257,1574,5421,113506
2020-08-27,07:30:00,89232,8182,10317,7650,2070,7045,124496
2020-08-27,08:00:00,96026,9586,11252,7924,1739,9188,135715
2020-08-27,08:30:00,103389,11465,12328,9026,2494,9704,148406
2020-08-27,09:00:00,108638,11748,13565,10858,3064,11986,159859
2020-08-27,09:30:00,108544,13155,13571,10127,3264,11297,159958
2020-08-27,10:00:00,108618,12613,14245,9683,3235,11120,159514
2020-08-27,10:30:00,107255,13232,14719,9754,3189,11483,159632
2020-08-27,11:00:00,102848,13013,14713,9473,3860,11138,155045
2020-08-27,11:30:00,106115,14232,16359,11051,4063,11750,163570
2020-08-27,12:00:00,109238,14549,16312,10952,4731,11374,167156
2020-08-27,12:30:00,110355,14647,17876,12909,4676,12555,173018
2020-08-27,13:00:00,109911,14552,17188,12744,4468,13020,171883
2020-08-27,13:30:00,106986,13922,16674,12177,4096,12836,166691
2020-08-27,14:00:00,106198,13130,15673,10722,4081,11795,161599
2020-08-27,14:30:00,105426,13512,16056,11648,4639,12678,163959
2020-08-27,15:00:00,104667,13900,15328,10872,4240,11659,160666
2020-08-27,15:30:00,100253,13038,14596,10561,3727,11144,153319
2020-08-27,16:00:00,106005,12244,14703,10656,4304,11277,159189
2020-08-27,16:30:00,105735,13140,15356,11012,4357,11511,161111
2020-08-27,17:00:00,107073,13242,17758,13062,4583,12434,168152
2020-08-27,17:30:00,108564,14197,17929,14041,5310,13745,173786
2020-08-27,18:00:00,104553,13227,17323,13660,4290,14422,167475
2020-08-27,18:30:00,108013,13417,19012,15377,4631,15161,175611
2020-08-27,19:00:00,112387,14280,18516,14902,4176,15442,179703
2020-08-27,19:30:00,109631,12886,16988,14343,4321,14146,172315
2020-08-27,20:00:00,103628,12748,14657,11786,4041,13056,159916
2020-08-27,20:30:00,98529,11111,17245,13335,4299,9936,154455
2020-08-27,21:00:00,102554,12963,15721,10328,2981,11516,156063
2020-08-27,21:30:00,107486,13615,14636,10277,3151,11367,160532
2020-08-27,22:00:00,105950,11889,13685,10178,3711,9999,155412
2020-08-27,22:30:00,101624,11454,12982,9126,3124,9749,148059
2020-08-27,23:00:00,101004,11187,12376,8789,3116,9792,146264
2020-08-27,23:30:00,106538,11945,13569,9367,3069,9299,153787
2020-08-28,00:00:00,102987,9929,12349,8000,3156,8468,144889
2020-08-28,00:30:00,97753,10980,12538,8359,4023,9434,143087
2020-08-28,01:00:00,83093,9075,10379,6168,2750,7610,119075
2020-08-28,01:30:00,82937,8982,10385,6553,2413,6483,117753
2020-08-28,02:00:00,81499,10634,10192,6467,2300,6914,118006
2020-08-28,02:30:00,76568,10978,10974,5544,2295,6152,112511
2020-08-28,03:00:00,73932,10299,11963,6130,2179,6612,111115
2020-08-28,03:30:00,72178,6633,12702,5381,2153,4045,103092
2020-08-28,04:00:00,73542,6693,12741,5246,2586,1200,102008
2020-08-28,04:30:00,73265,6539,12620,5616,2053,795,100888
2020-08-28,05:00:00,71158,6919,11853,5856,949,768,97503
2020-08-28,05:30:00,69391,6994,11949,5795,801,733,95663
2020-08-28,06:00:00,71447,7226,11902,5542,1234,949,98300
2020-08-28,06:30:00,83989,8931,10690,6408,1104,5353,116475
2020-08-28,07:00:00,86974,7949,9407,6486,1027,5869,117712
2020-08-28,07:30:00,90394,8171,10677,7892,1919,7154,126207
2020-08-28,08:00:00,96000,10993,11224,7767,1727,8607,136318
2020-08-28,08:30:00,104456,11551,12755,9508,1946,10613,150829
2020-08-28,09:00:00,108931,12634,14886,11162,2543,11832,161988
2020-08-28,09:30:00,108518,12152,14386,11184,2779,12851,161870
2020-08-28,10:00:00,56937,6442,7231,5218,1378,6339,83545
2020-08-28,10:30:00,106524,13037,15078,10127,3502,11400,159668
2020-08-28,11:00:00,107907,13355,15626,11045,3354,11386,162673
2020-08-28,11:30:00,109819,14246,16124,10482,3787,11803,166261
2020-08-28,12:00:00,109491,14940,16942,11663,4271,13593,170900
2020-08-28,12:30:00,113647,14817,18120,12476,5025,14250,178335
2020-08-28,13:00:00,110082,14041,16477,11815,4489,14032,170936
2020-08-28,13:30:00,111996,15742,18364,13412,4844,14739,179097
2020-08-28,14:00:00,107881,14536,15838,11981,3955,12827,167018
2020-08-28,14:30:00,108455,14606,15612,12196,4707,13190,168766
2020-08-28,15:00:00,106374,13444,15152,11224,4356,12844,163394
2020-08-28,15:30:00,104820,13176,15311,10829,4424,12246,160806
2020-08-28,16:00:00,99338,12756,15168,11004,3648,11447,153361
2020-08-28,16:30:00,101362,14011,16325,12181,4211,13842,161932
2020-08-28,17:00:00,106228,13961,17462,13778,4050,14454,169933
2020-08-28,17:30:00,104748,13389,17313,12684,4169,13369,165672
2020-08-28,18:00:00,108480,13329,16773,14699,4818,15936,174035
2020-08-28,18:30:00,108355,14082,18268,13882,4427,15648,174662
2020-08-28,19:00:00,109660,14131,19101,14374,4150,14884,176300
2020-08-28,19:30:00,114175,14210,17982,14489,4122,14636,179614
2020-08-28,20:00:00,113252,14770,18046,13780,4172,13660,177680
2020-08-28,20:30:00,114301,14647,18171,13232,4780,13151,178282
2020-08-28,21:00:00,109338,12876,15874,12409,3352,12212,166061
2020-08-28,21:30:00,106659,12835,15602,12370,3301,11026,161793
2020-08-28,22:00:00,107853,12981,15318,11278,3684,11230,162344
2020-08-28,22:30:00,103857,12319,14387,9752,3322,10427,154064
2020-08-28,23:00:00,102767,12211,14605,9581,3064,10044,152272
2020-08-28,23:30:00,101531,12001,14642,9903,3588,9558,151223
2020-08-29,00:00:00,101826,11098,13590,8826,4093,8656,148089
2020-08-29,00:30:00,105860,11242,14449,8135,4740,9132,153558
2020-08-29,01:00:00,94972,9647,10502,6965,2383,6978,131447
2020-08-29,01:30:00,92497,12937,12393,5169,2461,7020,132477
2020-08-29,02:00:00,87889,12771,12029,4994,2706,4264,124653
2020-08-29,02:30:00,86059,14124,13559,5322,2903,1905,123872
2020-08-29,03:00:00,79042,14853,14070,5460,2855,1039,117319
2020-08-29,03:30:00,77953,13552,13230,6387,2599,811,114532
2020-08-29,04:00:00,76629,13529,13522,6543,2840,852,113915
2020-08-29,04:30:00,73806,10968,11778,7755,3106,750,108163
2020-08-29,05:00:00,75004,9835,9869,7535,3153,668,106064
2020-08-29,05:30:00,73880,9848,9493,7347,2895,844,104307
2020-08-29,06:00:00,72226,11092,8563,7184,2212,908,102185
2020-08-29,06:30:00,80259,9563,9571,6705,1364,5287,112749
2020-08-29,07:00:00,80016,7699,8464,6086,1057,5374,108696
2020-08-29,07:30:00,80650,7786,8251,6121,1241,4841,108890
2020-08-29,08:00:00,83625,8194,9420,6977,1540,5525,115281
2020-08-29,08:30:00,87993,9388,10535,7324,1857,6476,123573
2020-08-29,09:00:00,91892,10128,11986,8370,2098,6824,131298
2020-08-29,09:30:00,94024,9348,10987,7873,2354,6729,131315
2020-08-29,10:00:00,59227,6378,7992,5878,1529,4984,85988
2020-08-29,10:30:00,100105,12371,14107,10030,3315,9606,149534
2020-08-29,11:00:00,101756,12639,14156,10335,3304,10202,152392
2020-08-29,11:30:00,104673,13018,15596,12063,2957,11125,159432
2020-08-29,12:00:00,105858,13269,15726,12170,3486,12542,163051
2020-08-29,12:30:00,107329,13783,15647,11465,4120,11959,164303
2020-08-29,13:00:00,107491,12116,15324,12824,3600,12714,164069
2020-08-29,13:30:00,108131,11907,14346,10742,3685,11454,160265
2020-08-29,14:00:00,105969,12279,14850,11578,3413,10826,158915
2020-08-29,14:30:00,105951,12194,15287,12826,3637,11723,161618
2020-08-29,15:00:00,102727,11625,14955,12473,3986,11102,156868
2020-08-29,15:30:00,103369,12409,15758,12729,3752,11976,159993
2020-08-29,16:00:00,104153,12440,15785,12784,4216,12161,161539
2020-08-29,16:30:00,103568,13226,15940,11745,4419,11107,160005
2020-08-29,17:00:00,103727,12504,15564,12572,4224,11967,160558
2020-08-29,17:30:00,105961,12240,15665,11226,3656,11484,160232
2020-08-29,18:00:00,104493,13258,15063,11470,3346,11108,158738
2020-08-29,18:30:00,107352,14370,17279,13502,4781,13441,170725
2020-08-29,19:00:00,110317,13983,16682,12423,4379,12675,170459
2020-08-29,19:30:00,113021,14704,17122,13253,4800,14327,177227
2020-08-29,20:00:00,115739,13325,17187,13058,4438,13086,176833
2020-08-29,20:30:00,112093,13332,15794,12830,4123,12565,170737
2020-08-29,21:00:00,110643,13025,15154,11575,4487,12454,167338
2020-08-29,21:30:00,109334,13940,14958,9970,4142,10839,163183
2020-08-29,22:00:00,106426,13300,14897,9955,3918,10592,159088
2020-08-29,22:30:00,105514,12473,12911,9126,3625,9518,153167
2020-08-29,23:00:00,105707,12681,13981,9287,3484,9466,154606
2020-08-29,23:30:00,104699,11998,12535,9536,3521,10055,152344
2020-08-30,00:00:00,101381,11677,13232,9524,3027,9257,148098
2020-08-30,00:30:00,104457,11148,12642,8268,3523,10042,150080
2020-08-30,01:00:00,97318,9275,8513,6283,1638,8293,131320
2020-08-30,01:30:00,92881,11319,10926,7302,2541,6960,131929
2020-08-30,02:00:00,90075,12783,11791,7082,2151,3475,127357
2020-08-30,02:30:00,85903,14062,12221,5507,2172,870,120735
2020-08-30,03:00:00,83508,14529,12424,5984,1952,935,119332
2020-08-30,03:30:00,81991,14999,12573,5718,2568,1100,118949
2020-08-30,04:00:00,81746,14200,11030,5524,1667,726,114893
2020-08-30,04:30:00,82051,12805,9649,6359,2103,788,113755
2020-08-30,05:00:00,79257,11713,7526,5994,2540,754,107784
2020-08-30,05:30:00,78281,11723,7289,6045,2091,588,106017
2020-08-30,06:00:00,78760,11917,8362,7179,1973,865,109056
2020-08-30,06:30:00,83506,9729,9769,6921,1927,5218,117070
2020-08-30,07:00:00,81839,7287,8994,5785,1291,5299,110495
2020-08-30,07:30:00,83289,7664,8779,6095,1638,5840,113305
2020-08-30,08:00:00,81680,7838,8703,5217,1451,5581,110470
2020-08-30,08:30:00,85950,8517,11391,8508,1754,5551,121671
2020-08-30,09:00:00,89776,9564,10195,7083,1658,5934,124210
2020-08-30,09:30:00,93495,9758,10432,7364,1834,6441,129324
2020-08-30,10:00:00,100886,11050,12098,8928,3062,8022,144046
2020-08-30,10:30:00,103965,11916,12250,8200,2877,10287,149495
2020-08-30,11:00:00,109489,13291,14727,10632,2992,9851,160982
2020-08-30,11:30:00,111054,15517,16871,11532,3640,10732,169346
2020-08-30,12:00:00,112203,15482,16932,11928,3810,11666,172021
2020-08-30,12:30:00,114471,16046,16791,10775,4871,10981,173935
2020-08-30,13:00:00,98037,15357,16250,10368,4126,9947,154085
2020-08-30,13:30:00,113648,14797,16749,10543,4493,10719,170949
2020-08-30,14:00:00,113344,14954,15373,10467,3965,9783,167886
2020-08-30,14:30:00,108487,13974,15355,10832,3873,9423,161944
2020-08-30,15:00:00,107322,14389,15878,10170,4039,10350,162148
2020-08-30,15:30:00,113426,12909,15149,10106,4410,9473,165473
2020-08-30,16:00:00,111916,12474,15518,11150,3698,9775,164531
2020-08-30,16:30:00,111898,13516,15813,11401,4565,11033,168226
2020-08-30,17:00:00,113952,13984,16134,11277,4994,11139,171480
2020-08-30,17:30:00,114359,13868,16045,10926,4852,11998,172048
2020-08-30,18:00:00,116877,13767,16253,11427,4817,12262,175403
2020-08-30,18:30:00,117782,14387,17090,13206,4707,13459,180631
2020-08-30,19:00:00,117929,15048,17463,13209,5232,12906,181787
2020-08-30,19:30:00,122033,14001,17262,13757,4410,13429,184892
2020-08-30,20:00:00,120857,14219,17120,12854,3919,13631,182600
2020-08-30,20:30:00,121480,14902,17021,12854,4224,11619,182100
2020-08-30,21:00:00,122528,15747,16862,12434,4389,12555,184515
2020-08-30,21:30:00,110373,13689,15975,10907,4478,11261,166683
2020-08-30,22:00:00,108397,13346,15812,10858,3846,10402,162661
2020-08-30,22:30:00,105471,13056,14711,9964,4254,10122,157578
2020-08-30,23:00:00,105876,13840,14081,9244,4423,10088,157552
2020-08-30,23:30:00,105617,12057,14104,9340,3849,10144,155111
2020-08-31,00:00:00,113082,12925,14505,9663,3514,8986,162675
2020-08-31,00:30:00,109490,11676,12925,8481,3480,8860,154912
2020-08-31,01:00:00,98102,11440,12719,5331,2169,6737,136498
2020-08-31,01:30:00,94178,12716,13553,5605,2704,6634,135390
2020-08-31,02:00:00,92821,14362,14681,5500,2995,950,131309
2020-08-31,02:30:00,89052,14337,13838,5360,2828,772,126187
2020-08-31,03:00:00,89053,14000,13989,6123,3068,940,127173
2020-08-31,03:30:00,85054,11965,10050,5793,3543,697,117102
2020-08-31,04:00:00,79364,11513,8188,5816,3256,852,108989
2020-08-31,04:30:00,78767,11121,7225,5991,2149,792,106045
2020-08-31,05:00:00,76789,11339,7065,5796,2179,929,104097
2020-08-31,05:30:00,79104,11490,7446,6122,2061,878,107101
2020-08-31,06:00:00,81978,11571,8704,7270,2461,1340,113324
2020-08-31,06:30:00,93366,10800,10562,7016,2212,5204,129160
2020-08-31,07:00:00,95503,9049,10576,6921,2242,6299,130590
2020-08-31,07:30:00,99640,9320,10817,7281,2370,6994,136422
2020-08-31,08:00:00,107822,11043,12036,8079,2995,8606,150581
2020-08-31,08:30:00,113318,13094,14057,9904,3793,12187,166353
2020-08-31,09:00:00,119577,13910,14866,11340,4247,13846,177786
2020-08-31,09:30:00,118480,14993,16146,11628,4606,12514,178367
2020-08-31,10:00:00,119327,15368,16255,11335,4831,13873,180989
2020-08-31,10:30:00,119600,14773,16490,10735,4512,12272,178382
2020-08-31,11:00:00,118219,14697,16035,10493,5310,12815,177569
2020-08-31,11:30:00,123070,16188,17513,11896,5450,13615,187732
2020-08-31,12:00:00,122300,15132,17591,11799,5436,13123,185381
2020-08-31,12:30:00,125525,16220,18124,13924,5503,15479,194775
2020-08-31,13:00:00,129201,16579,19692,15069,5734,15928,202203
2020-08-31,13:30:00,130145,16992,19735,15391,6335,15960,204558
2020-08-31,14:00:00,130672,17714,20210,15399,5373,14593,203961
2020-08-31,14:30:00,127562,16116,19268,14346,5163,14503,196958
2020-08-31,15:00:00,122057,14447,16407,12823,4319,13299,183352
2020-08-31,15:30:00,121343,14687,16801,12671,4467,14223,184192
2020-08-31,16:00:00,124804,15558,18203,13644,5945,14516,192670
2020-08-31,16:30:00,130249,16057,20160,14791,5458,15659,202374
2020-08-31,17:00:00,130199,17001,20986,15092,5416,16168,204862
2020-08-31,17:30:00,131652,18970,21514,15674,6691,16990,211491
2020-08-31,18:00:00,107481,15866,22590,17267,6642,18203,188049
2020-08-31,18:30:00,129157,16774,21613,17157,5303,18122,208126
2020-08-31,19:00:00,135648,17102,21713,17408,5524,17896,215291
2020-08-31,19:30:00,133492,16559,20877,15418,5969,16461,208776
2020-08-31,20:00:00,127439,16510,20396,15691,6139,16515,202690
2020-08-31,20:30:00,126423,16675,21599,16524,5674,17434,204329
2020-08-31,21:00:00,124928,16459,20853,15365,5043,15449,198097
2020-08-31,21:30:00,127757,15489,18902,14038,5266,13893,195345
2020-08-31,22:00:00,121300,14324,16793,12313,4986,12529,182245
2020-08-31,22:30:00,118681,13380,16279,11632,4289,11000,175261
2020-08-31,23:00:00,115879,14135,17194,11480,4506,10971,174165
2020-08-31,23:30:00,112851,13253,15126,10626,4803,11078,167737
2020-09-01,00:00:00,113438,12093,14290,10320,3886,11126,165153
2020-09-01,00:30:00,112532,13671,15730,8392,3106,10956,164387
2020-09-01,01:00:00,100979,13216,14260,5525,1765,10250,145995
2020-09-01,01:30:00,94328,13361,14348,5405,3067,9184,139693
2020-09-01,02:00:00,91564,12886,13969,5311,2876,5271,131877
2020-09-01,02:30:00,87415,13376,15297,6943,2649,5537,131217
2020-09-01,03:00:00,81435,13086,14281,6442,2711,5276,123231
2020-09-01,03:30:00,77767,12108,15417,6763,2617,5021,119693
2020-09-01,04:00:00,75230,8027,14856,6592,2284,5010,111999
2020-09-01,04:30:00,74202,7733,14534,6506,2756,1329,107060
2020-09-01,05:00:00,68870,8434,15735,7078,2766,1648,104531
2020-09-01,05:30:00,69470,8343,14602,7164,1538,1646,102763
2020-09-01,06:00:00,72702,11534,14397,7534,1608,2112,109887
2020-09-01,06:30:00,93001,11686,11769,7952,1644,6298,132350
2020-09-01,07:00:00,99557,10408,11532,7395,1894,8382,139168
2020-09-01,07:30:00,107011,11098,11298,7965,1563,9683,148618
2020-09-01,08:00:00,112901,11794,12254,9113,2898,10943,159903
2020-09-01,08:30:00,122002,13008,14023,10497,4080,12921,176531
2020-09-01,09:00:00,126973,15703,16972,13012,4593,16144,193397
2020-09-01,09:30:00,131186,16878,19347,14429,4711,15685,202236
2020-09-01,10:00:00,129489,15660,19038,13884,4425,15245,197741
2020-09-01,10:30:00,126167,15722,20036,13469,4600,16122,196116
2020-09-01,11:00:00,121655,15728,19487,13343,4965,14984,190162
2020-09-01,11:30:00,118589,14412,18538,13540,5114,14505,184698
2020-09-01,12:00:00,117406,14007,17109,12328,4900,14003,179753
2020-09-01,12:30:00,124681,14989,18487,14136,5130,15221,192644
2020-09-01,13:00:00,122952,16250,18416,13909,5321,14204,191052
2020-09-01,13:30:00,126962,16911,19302,14401,5655,14223,197454
2020-09-01,14:00:00,123948,15138,18880,13082,6073,14342,191463
2020-09-01,14:30:00,127146,15659,18834,13065,5561,14266,194531
2020-09-01,15:00:00,123888,15608,18364,13069,4816,13341,189086
2020-09-01,15:30:00,122988,13343,17589,13257,4803,14557,186537
2020-09-01,16:00:00,121205,13580,17511,12591,4454,13993,183334
2020-09-01,16:30:00,115646,13537,16759,12792,4866,14478,178078
2020-09-01,17:00:00,118643,15539,19785,14426,5763,15727,189883
2020-09-01,17:30:00,122849,15720,20499,16271,4693,16455,196487
2020-09-01,18:00:00,121818,15184,19282,15358,4569,16543,192754
2020-09-01,18:30:00,127114,16396,20481,15241,5403,15633,200268
2020-09-01,19:00:00,134392,17045,22487,17621,4660,18976,215181
2020-09-01,19:30:00,131776,17583,20751,16347,5821,17263,209541
2020-09-01,20:00:00,126867,17693,21345,15206,5947,15855,202913
2020-09-01,20:30:00,125314,15574,18287,12054,5038,12397,188664
2020-09-01,21:00:00,125443,15430,18407,12208,5130,12335,188953
2020-09-01,21:30:00,126424,15829,18624,12705,5320,12724,191626
2020-09-01,22:00:00,125459,16117,18183,12245,5477,12910,190391
2020-09-01,22:30:00,121971,15496,17249,11401,5385,12261,183763
2020-09-01,23:00:00,118057,14129,16183,10255,5084,11213,174921
2020-09-01,23:30:00,116869,13057,14471,10218,4916,11266,170797
2020-09-02,00:00:00,116152,13487,14679,9825,4436,10714,169293
2020-09-02,00:30:00,117049,12379,14217,8843,3601,11093,167182
2020-09-02,01:00:00,103084,11856,13641,6963,3582,10288,149414
2020-09-02,01:30:00,103133,12727,13358,5531,2774,8355,145878
2020-09-02,02:00:00,100708,10877,12535,6632,2103,7323,140178
2020-09-02,02:30:00,96789,12493,12985,6663,2743,5766,137439
2020-09-02,03:00:00,92369,13619,13373,6805,3271,1183,130620
2020-09-02,03:30:00,86968,10041,9992,6134,3336,830,117301
2020-09-02,04:00:00,84238,9413,9452,7462,2767,664,113996
2020-09-02,04:30:00,80124,10093,8207,6935,1944,752,108055
2020-09-02,05:00:00,82349,9905,8321,7285,1668,886,110414
2020-09-02,05:30:00,80920,10010,8281,7104,1685,705,108705
2020-09-02,06:00:00,80904,11235,8649,7243,2226,1088,111345
2020-09-02,06:30:00,95283,11078,11098,8119,1824,6093,133495
2020-09-02,07:00:00,97303,10174,11208,8207,1931,6654,135477
2020-09-02,07:30:00,106401,10885,12126,8235,2579,7769,147995
2020-09-02,08:00:00,112406,12435,13632,10705,3339,9606,162123
2020-09-02,08:30:00,119720,13166,15456,12225,3502,13054,177123
2020-09-02,09:00:00,123578,15199,15783,12338,3489,12656,183043
2020-09-02,09:30:00,128101,15140,16525,12081,4758,13665,190270
2020-09-02,10:00:00,125380,15607,18012,12735,4736,14694,191164
2020-09-02,10:30:00,122123,14163,16382,11386,4020,13193,181267
2020-09-02,11:00:00,121161,15484,18102,11846,4687,14249,185529
2020-09-02,11:30:00,121348,15334,18158,11772,5550,14787,186949
2020-09-02,12:00:00,127365,17322,19276,13647,5811,15391,198812
2020-09-02,12:30:00,127968,16877,18343,14323,5944,16397,199852
2020-09-02,13:00:00,125622,16519,19559,14764,5225,16524,198213
2020-09-02,13:30:00,125042,16078,19460,14532,4645,15596,195353
2020-09-02,14:00:00,125637,16199,20626,14924,4687,15073,197146
2020-09-02,14:30:00,123936,15649,18513,13487,4984,13862,190431
2020-09-02,15:00:00,118857,14626,17065,12293,4572,13464,180877
2020-09-02,15:30:00,121206,15052,17716,13107,4890,14726,186697
2020-09-02,16:00:00,121807,15465,18294,13567,4598,15001,188732
2020-09-02,16:30:00,119378,15698,18653,14058,4166,14006,185959
2020-09-02,17:00:00,123628,16289,20668,15686,5316,16468,198055
2020-09-02,17:30:00,125419,16813,19683,15544,5200,16428,199087
2020-09-02,18:00:00,125470,16925,21679,16923,5965,17122,204084
2020-09-02,18:30:00,126575,16448,21912,17554,5403,18686,206578
2020-09-02,19:00:00,130004,17924,22050,17769,5890,18911,212548
2020-09-02,19:30:00,131479,17445,20587,16076,6142,17099,208828
2020-09-02,20:00:00,127676,16592,20232,14501,6380,15123,200504
2020-09-02,20:30:00,125115,16316,18876,12375,5589,12771,191042
2020-09-02,21:00:00,122803,14993,17928,12086,4886,11609,184305
2020-09-02,21:30:00,121708,14459,17140,12112,5036,11744,182199
2020-09-02,22:00:00,119427,15513,16202,10477,5348,12059,179026
2020-09-02,22:30:00,119105,15607,16405,10232,5002,10636,176987
2020-09-02,23:00:00,119321,15380,16460,9795,5098,11408,177462
2020-09-02,23:30:00,118012,14786,16247,9694,4803,10390,173932
2020-09-03,00:00:00,114063,13640,14728,9150,4577,9602,165760
2020-09-03,00:30:00,109847,15189,14921,8621,5137,9188,162903
2020-09-03,01:00:00,100714,12556,13517,5908,3432,5570,141697
2020-09-03,01:30:00,96333,15095,13525,5591,3087,4312,137943
2020-09-03,02:00:00,89817,14899,14099,5703,2905,3699,131122
2020-09-03,02:30:00,83823,16824,14575,5616,3250,3271,127359
2020-09-03,03:00:00,77844,13619,14263,6156,2737,467,115086
2020-09-03,03:30:00,77436,15053,12993,5522,2564,601,114169
2020-09-03,04:00:00,75442,13916,11718,5741,3716,587,111120
2020-09-03,04:30:00,77507,11201,8011,5657,3152,499,106027
2020-09-03,05:00:00,77215,11028,8440,6564,2828,514,106589
2020-09-03,05:30:00,76979,10499,7866,6655,2224,545,104768
2020-09-03,06:00:00,80570,11430,8810,7721,2192,851,111574
2020-09-03,06:30:00,95339,11346,11149,7569,2129,6628,134160
2020-09-03,07:00:00,95616,10407,11910,7303,2284,7691,135211
2020-09-03,07:30:00,103190,11556,12620,8438,2623,8722,147149
2020-09-03,08:00:00,111869,11917,13746,10170,3008,9732,160442
2020-09-03,08:30:00,119907,13310,15334,12115,3239,12475,176380
2020-09-03,09:00:00,131254,16584,18745,13566,5009,15730,200888
2020-09-03,09:30:00,130680,15978,18782,14070,4892,15780,200182
2020-09-03,10:00:00,127504,16785,19195,13509,5423,14218,196634
2020-09-03,10:30:00,122526,15860,18242,11592,5560,12410,186190
2020-09-03,11:00:00,119495,15158,16215,10246,4454,12062,177630
2020-09-03,11:30:00,118813,14875,16758,10671,4774,12510,178401
2020-09-03,12:00:00,118132,14592,17301,11097,5094,12959,179175
2020-09-03,12:30:00,120778,15369,18343,13466,4759,13068,185783
2020-09-03,13:00:00,122289,15490,17606,12821,4768,14083,187057
2020-09-03,13:30:00,119468,16274,18569,13356,5108,13474,186249
2020-09-03,14:00:00,122032,16778,19001,13959,5333,15030,192133
2020-09-03,14:30:00,117769,15434,17644,12700,4537,12544,180628
2020-09-03,15:00:00,117862,15166,17117,12215,4439,13500,180299
2020-09-03,15:30:00,120066,14877,18186,12575,5013,14237,184954
2020-09-03,16:00:00,117221,14654,17573,12205,5028,14075,180756
2020-09-03,16:30:00,118962,14786,19140,13261,4986,15010,186145
2020-09-03,17:00:00,119276,14426,18925,14428,5237,15880,188172
2020-09-03,17:30:00,124899,15825,20548,17494,5617,19148,203531
2020-09-03,18:00:00,120284,14499,19705,16740,4682,18827,194737
2020-09-03,18:30:00,125967,16096,20732,17323,5290,19036,204444
2020-09-03,19:00:00,127702,18090,22566,17033,5432,18462,209285
2020-09-03,19:30:00,132031,18028,21196,15813,5711,17043,209822
2020-09-03,20:00:00,126550,17096,19845,14729,5128,15444,198792
2020-09-03,20:30:00,124784,15439,17923,13187,4643,12731,188707
2020-09-03,21:00:00,123321,15034,18273,13079,4574,13062,187343
2020-09-03,21:30:00,120137,15507,17686,12630,4865,12000,182825
2020-09-03,22:00:00,117181,15436,17158,11715,4325,12313,178128
2020-09-03,22:30:00,118447,15467,17882,11660,5267,12684,181407
2020-09-03,23:00:00,115565,15849,16255,11157,4919,11619,175364
2020-09-03,23:30:00,114693,14574,15738,10358,4927,11270,171560
2020-09-04,00:00:00,115474,13327,14734,10269,3784,11506,169094
2020-09-04,00:30:00,112444,13729,14200,8403,3226,11482,163484
2020-09-04,01:00:00,103458,12540,13813,7530,3016,12384,152741
2020-09-04,01:30:00,101063,11959,14330,6450,2866,9766,146434
2020-09-04,02:00:00,97939,15313,16409,6669,3851,6312,146493
2020-09-04,02:30:00,95699,14923,16206,7291,2857,5273,142249
2020-09-04,03:00:00,90357,13855,14507,6224,3517,5454,133914
2020-09-04,03:30:00,85076,12890,12853,5664,2839,5140,124462
2020-09-04,04:00:00,84434,13621,14337,7087,3064,3968,126511
2020-09-04,04:30:00,82916,12062,11190,7010,2299,801,116278
2020-09-04,05:00:00,81022,11609,8690,7071,2165,768,111325
2020-09-04,05:30:00,76514,11987,9000,7249,2589,869,108208
2020-09-04,06:00:00,80736,11776,9648,7925,2658,1527,114270
2020-09-04,06:30:00,97637,12474,12180,8304,2323,6493,139411
2020-09-04,07:00:00,100113,11098,12424,8446,2326,7732,142139
2020-09-04,07:30:00,106227,11704,14037,9367,2971,9186,153492
2020-09-04,08:00:00,114970,12085,14851,10457,2983,10824,166170
2020-09-04,08:30:00,120312,12998,15226,11147,3947,12881,176511
2020-09-04,09:00:00,126062,16239,17236,12511,5096,14442,191586
2020-09-04,09:30:00,128908,17433,19787,14535,5819,15070,201552
2020-09-04,10:00:00,127970,16946,18785,13386,5203,14946,197236
2020-09-04,10:30:00,127873,16907,19099,14093,5311,14695,197978
2020-09-04,11:00:00,125968,16695,19578,13398,4891,15285,195815
2020-09-04,11:30:00,123010,15915,19005,13719,5203,15369,192221
2020-09-04,12:00:00,121356,15752,17761,12930,5094,14918,187811
2020-09-04,12:30:00,121598,16125,18546,14105,4987,15413,190774
2020-09-04,13:00:00,122697,17106,19974,15953,5152,16612,197494
2020-09-04,13:30:00,120773,16834,19191,14728,5302,15016,191844
2020-09-04,14:00:00,123580,16776,19780,14536,5725,14969,195366
2020-09-04,14:30:00,123047,15802,19763,13474,6158,14096,192340
2020-09-04,15:00:00,118818,15844,18451,12163,5154,13271,183701
2020-09-04,15:30:00,127902,14718,17823,13923,6194,15453,196013
2020-09-04,16:00:00,129117,16934,18153,15424,6081,14177,199886
2020-09-04,16:30:00,129830,17210,21767,16841,6334,14686,206668
2020-09-04,17:00:00,128295,16625,21200,14724,6456,17875,205175
2020-09-04,17:30:00,128087,17219,21673,16248,5810,18609,207646
2020-09-04,18:00:00,123929,15606,20421,15558,5141,17877,198532
2020-09-04,18:30:00,123541,16449,20311,15767,5455,16679,198202
2020-09-04,19:00:00,129373,17941,22729,17848,5764,18849,212504
2020-09-04,19:30:00,122896,15776,20537,16332,5416,15604,196561
2020-09-04,20:00:00,126867,16064,20893,14961,5504,16423,200712
2020-09-04,20:30:00,123982,16238,20774,16000,5214,15591,197799
2020-09-04,21:00:00,122517,15570,19377,14863,5062,15196,192585
2020-09-04,21:30:00,122731,16899,19647,14217,5655,13969,193118
2020-09-04,22:00:00,118312,15316,18306,12971,5078,12989,182972
2020-09-04,22:30:00,117477,14709,18243,12708,4685,12550,180372
2020-09-04,23:00:00,114702,13843,16417,11917,4467,12023,173369
2020-09-04,23:30:00,114862,13123,15818,11278,4771,11567,171419
2020-09-05,00:00:00,114083,13483,14116,9826,4834,10380,166722
2020-09-05,00:30:00,115101,13322,13496,9011,4780,11364,167074
2020-09-05,01:00:00,103728,11077,10879,6211,3611,10104,145610
2020-09-05,01:30:00,102613,12697,12760,6106,3964,7313,145453
2020-09-05,02:00:00,98856,11303,11710,6011,2023,920,130823
2020-09-05,02:30:00,96532,13321,12329,5903,2857,630,131572
2020-09-05,03:00:00,91913,14076,13377,6982,2826,834,130008
2020-09-05,03:30:00,84671,14162,12575,5913,1708,747,119776
2020-09-05,04:00:00,82681,14641,13383,6266,1872,554,119397
2020-09-05,04:30:00,77381,14389,12615,6167,1768,599,112919
2020-09-05,05:00:00,73728,14136,12345,5810,1462,646,108127
2020-09-05,05:30:00,72482,13763,12466,6052,1583,577,106923
2020-09-05,06:00:00,73451,11534,12618,7177,1593,674,107047
2020-09-05,06:30:00,89753,11712,11942,6573,2156,5316,127452
2020-09-05,07:00:00,89707,8481,8868,5797,1874,4975,119702
2020-09-05,07:30:00,89409,8279,9012,5615,2020,5037,119372
2020-09-05,08:00:00,93984,9421,11063,7351,2594,6247,130660
2020-09-05,08:30:00,97954,9698,11521,7452,2721,6932,136278
2020-09-05,09:00:00,103311,10695,12954,8612,3120,9428,148120
2020-09-05,09:30:00,111433,10907,13069,8696,3055,8932,156092
2020-09-05,10:00:00,108178,11867,14218,9786,3383,9519,156951
2020-09-05,10:30:00,108912,12760,16115,10714,3800,11164,163465
2020-09-05,11:00:00,112382,15145,17003,12604,4685,13536,175355
2020-09-05,11:30:00,115888,14483,17830,13080,4658,14146,180085
2020-09-05,12:00:00,117403,15518,18963,14206,4875,14538,185503
2020-09-05,12:30:00,116208,15048,18646,13862,5267,15091,184122
2020-09-05,13:00:00,115608,15158,18895,14036,4530,13880,182107
2020-09-05,13:30:00,117910,16311,17641,13607,4088,13814,183371
2020-09-05,14:00:00,118383,15158,18475,13842,4366,14652,184876
2020-09-05,14:30:00,115295,16041,18461,13702,5306,13389,182194
2020-09-05,15:00:00,119127,15406,18347,12501,4568,13910,183859
2020-09-05,15:30:00,114373,14113,17745,13935,4223,13240,177629
2020-09-05,16:00:00,113172,13940,17452,13715,4680,13766,176725
2020-09-05,16:30:00,113960,15443,17500,12739,4932,13451,178025
2020-09-05,17:00:00,114872,14560,18114,13657,4353,13956,179512
2020-09-05,17:30:00,123926,14306,18108,14383,4077,14387,189187
2020-09-05,18:00:00,107481,15125,17575,13604,4689,14634,173108
2020-09-05,18:30:00,124310,15945,21411,16644,5397,16099,199806
2020-09-05,19:00:00,124113,15154,20768,16302,5154,16411,197902
2020-09-05,19:30:00,123143,15878,20538,15603,5333,16833,197328
2020-09-05,20:00:00,127041,14924,19310,14682,5273,14908,196138
2020-09-05,20:30:00,124431,16023,19733,15503,5159,14918,195767
2020-09-05,21:00:00,124289,16185,19534,14031,4903,14886,193828
2020-09-05,21:30:00,120449,16159,19076,13841,5348,14270,189143
2020-09-05,22:00:00,119918,14488,16859,11370,4231,12560,179426
2020-09-05,22:30:00,117774,14166,16945,11374,4519,12915,177693
2020-09-05,23:00:00,114946,13479,17343,11448,4768,12416,174400
2020-09-05,23:30:00,112690,12804,16057,9914,4884,10354,166703
2020-09-06,00:00:00,114556,12470,14505,10468,4754,12602,169355
2020-09-06,00:30:00,111523,14469,14639,9344,3980,13008,166963
2020-09-06,01:00:00,102519,12734,11750,8051,2876,12030,149960
2020-09-06,01:30:00,100176,13816,13738,7220,3579,11105,149634
2020-09-06,02:00:00,93074,15368,15089,6522,3600,5162,138815
2020-09-06,02:30:00,88828,14577,13541,5986,2850,4266,130048
2020-09-06,03:00:00,88405,14363,13738,5648,2812,3460,128426
2020-09-06,03:30:00,89974,14685,13775,5966,3130,1019,128549
2020-09-06,04:00:00,88832,13664,13745,6058,3146,607,126052
2020-09-06,04:30:00,84364,14134,12851,5942,2237,697,120225
2020-09-06,05:00:00,80969,13642,11071,7032,2156,693,115563
2020-09-06,05:30:00,80673,10758,7657,6257,2128,641,108114
2020-09-06,06:00:00,83201,11734,7827,6648,2287,734,112431
2020-09-06,06:30:00,91763,10821,11768,7800,1770,5483,129405
2020-09-06,07:00:00,88773,8739,9969,6345,1746,5821,121393
2020-09-06,07:30:00,89905,8811,9781,6016,2020,5605,122138
2020-09-06,08:00:00,90229,9371,10437,6651,2983,6555,126226
2020-09-06,08:30:00,94762,10127,11144,6174,2301,6589,131097
2020-09-06,09:00:00,101610,10644,12289,8032,2389,7435,142399
2020-09-06,09:30:00,103455,11261,11770,8030,2633,8167,145316
2020-09-06,10:00:00,109002,13247,13914,9199,3561,9723,158646
2020-09-06,10:30:00,108382,14500,15020,9948,3616,9585,161051
2020-09-06,11:00:00,112260,15050,16639,11104,4586,11283,170922
2020-09-06,11:30:00,114988,15818,17022,11393,4496,10830,174547
2020-09-06,12:00:00,116165,16722,18320,13186,5049,12245,181687
2020-09-06,12:30:00,116938,16273,18490,12447,4435,12616,181199
2020-09-06,13:00:00,117319,16495,18317,12518,4813,12641,182103
2020-09-06,13:30:00,116902,16429,17161,13871,4735,11713,180811
2020-09-06,14:00:00,117218,14226,19080,11616,4657,14593,181390
2020-09-06,14:30:00,114820,15802,18422,13150,4838,11345,178377
2020-09-06,15:00:00,118166,13756,15468,12501,5014,13341,178246
2020-09-06,15:30:00,115643,14041,16333,12895,5532,13844,178288
2020-09-06,16:00:00,117209,15741,17221,11737,6159,14177,182244
2020-09-06,16:30:00,116035,14894,16563,11270,5919,12254,176935
2020-09-06,17:00:00,119158,15272,16760,12030,6095,15504,184819
2020-09-06,17:30:00,121354,14430,17541,15394,5890,12625,187234
2020-09-06,18:00:00,118821,15066,18024,12188,5669,12706,182474
2020-09-06,18:30:00,122421,16448,20577,16048,5620,12992,194106
2020-09-06,19:00:00,125639,15115,21620,16849,6035,17651,202909
2020-09-06,19:30:00,126805,15680,20751,15634,6562,16329,201761
2020-09-06,20:00:00,126971,15406,18566,14961,6117,15369,197390
2020-09-06,20:30:00,126845,16527,18856,13214,5907,14598,195947
2020-09-06,21:00:00,124537,14403,16806,12056,4556,13670,186028
2020-09-06,21:30:00,125701,13969,16880,11782,5101,12585,186018
2020-09-06,22:00:00,124862,13938,16337,10877,4596,11209,181819
2020-09-06,22:30:00,121680,14065,15837,10443,3970,10369,176364
2020-09-06,23:00:00,118308,14099,15636,9712,4611,11772,174138
2020-09-06,23:30:00,122448,14167,15857,11012,4903,11430,179817
2020-09-07,00:00:00,115434,12937,13952,9591,3887,10395,166196
2020-09-07,00:30:00,115943,12244,14446,8389,4569,10589,166180
2020-09-07,01:00:00,106404,12781,13018,7660,3740,10240,153843
2020-09-07,01:30:00,100375,11257,12179,6162,2481,6932,139386
2020-09-07,02:00:00,97401,12305,13855,5963,2896,4327,136747
2020-09-07,02:30:00,83694,12261,12008,5821,853,347,114984
2020-09-07,03:00:00,90638,12923,13640,6273,2954,797,127225
2020-09-07,03:30:00,84102,13492,12267,5879,1557,845,118142
2020-09-07,04:00:00,85088,13231,11387,5715,1627,843,117891
2020-09-07,04:30:00,85071,9780,8053,6719,2024,864,112511
2020-09-07,05:00:00,83197,9607,7814,6732,1673,958,109981
2020-09-07,05:30:00,84715,9695,8430,7227,1919,1070,113056
2020-09-07,06:00:00,86461,10552,8757,7267,2311,1112,116460
2020-09-07,06:30:00,98646,10458,11730,7930,1590,7465,137819
2020-09-07,07:00:00,101131,10365,12564,8492,2077,8097,142726
2020-09-07,07:30:00,105932,10874,12433,9058,2264,8223,148784
2020-09-07,08:00:00,119846,12857,16338,11488,3370,11917,175816
2020-09-07,08:30:00,125633,13130,15490,12215,3765,13288,183521
2020-09-07,09:00:00,128494,14861,16077,12646,4661,14475,191214
2020-09-07,09:30:00,129027,15433,17785,13402,4245,15658,195550
2020-09-07,10:00:00,126638,14920,17621,11974,4123,14670,189946
2020-09-07,10:30:00,120535,16066,17338,11993,4840,13175,183947
2020-09-07,11:00:00,115324,14573,16556,11962,4063,12809,175287
2020-09-07,11:30:00,117937,15018,15771,11231,3964,13326,177247
2020-09-07,12:00:00,120019,14799,15376,10331,4185,14318,179028
2020-09-07,12:30:00,116949,14217,18604,13669,4465,12449,180353
2020-09-07,13:00:00,118914,14090,16761,12155,4692,14529,181141
2020-09-07,13:30:00,122625,16485,18660,13352,4680,15231,191033
2020-09-07,14:00:00,121872,16343,19026,13371,5199,14314,190125
2020-09-07,14:30:00,121403,16100,18925,13955,5083,15225,190691
2020-09-07,15:00:00,120773,15317,18336,12080,5443,14253,186202
2020-09-07,15:30:00,122753,14488,17894,12514,5263,13611,186523
2020-09-07,16:00:00,121329,14783,17519,11923,5140,13325,184019
2020-09-07,16:30:00,118816,16391,17449,11939,5701,14284,184580
2020-09-07,17:00:00,113886,15200,16206,10405,4780,13366,173843
2020-09-07,17:30:00,114918,14130,17830,14312,4090,15383,180663
2020-09-07,18:00:00,117072,14997,19653,15096,5489,17398,189705
2020-09-07,18:30:00,116651,15095,19675,15345,5469,17082,189317
2020-09-07,19:00:00,126012,18063,21949,16260,5664,18562,206510
2020-09-07,19:30:00,124706,18365,21576,16330,5322,17226,203525
2020-09-07,20:00:00,121888,16107,19629,15038,5228,15775,193665
2020-09-07,20:30:00,123371,16609,18110,13152,5394,14294,190930
2020-09-07,21:00:00,126519,15848,19312,13638,5233,13733,194283
2020-09-07,21:30:00,117966,16692,17575,11222,5356,11886,180697
2020-09-07,22:00:00,117565,14715,16604,11347,5060,12172,177463
2020-09-07,22:30:00,118555,15996,16458,11016,5168,11327,178520
2020-09-07,23:00:00,114757,15294,15778,10362,4548,12193,172932
2020-09-07,23:30:00,112097,13895,15186,10847,3706,11602,167333
2020-09-08,00:00:00,110610,13464,14064,9347,3838,10158,161481
2020-09-08,00:30:00,110006,13380,13536,8613,3209,10461,159205
2020-09-08,01:00:00,97182,14372,13362,7075,2548,9433,143972
2020-09-08,01:30:00,92160,14944,13804,6276,2141,7961,137286
2020-09-08,02:00:00,89111,12419,11830,6379,2287,5605,127631
2020-09-08,02:30:00,85447,12451,11733,6516,2067,5122,123336
2020-09-08,03:00:00,80512,11847,10680,5520,1418,4606,114583
2020-09-08,03:30:00,75935,11637,11653,5755,1683,4935,111598
2020-09-08,04:00:00,74672,10016,8125,6704,2201,3890,105608
2020-09-08,04:30:00,75184,10196,8011,6570,2270,759,102990
2020-09-08,05:00:00,77020,10385,7732,6298,2170,696,104301
2020-09-08,05:30:00,78798,10125,7960,6464,1945,616,105908
2020-09-08,06:00:00,81323,10182,9022,7786,1929,1271,111513
2020-09-08,06:30:00,91439,11475,11310,8013,2136,6514,130887
2020-09-08,07:00:00,96815,10725,11514,8277,2391,7369,137091
2020-09-08,07:30:00,100744,10938,12802,9632,2159,8075,144350
2020-09-08,08:00:00,113357,13432,15247,11863,3386,11899,169184
2020-09-08,08:30:00,122325,15177,16340,12830,4223,13248,184143
2020-09-08,09:00:00,129055,17386,18999,15132,5421,16205,202198
2020-09-08,09:30:00,122993,16636,17597,12586,4988,14452,189252
2020-09-08,10:00:00,122755,17012,18402,12200,4455,14416,189240
2020-09-08,10:30:00,121155,16374,17954,12525,4539,13930,186477
2020-09-08,11:00:00,124267,16528,16281,12523,4271,13698,187568
2020-09-08,11:30:00,120033,17195,17230,11605,4790,13350,184203
2020-09-08,12:00:00,121905,16768,17360,12067,4616,13709,186425
2020-09-08,12:30:00,125379,15226,18351,13705,4350,14674,191685
2020-09-08,13:00:00,120912,14273,18206,13908,4391,14642,186332
2020-09-08,13:30:00,126010,15736,18873,13976,4557,14893,194045
2020-09-08,14:00:00,125838,15852,18648,13087,4970,14852,193247
2020-09-08,14:30:00,122683,15521,17830,13123,4800,14630,188587
2020-09-08,15:00:00,124882,14927,17874,12952,4220,14086,188941
2020-09-08,15:30:00,121169,15137,17041,11839,4096,13726,183008
2020-09-08,16:00:00,122886,14876,16741,11614,5081,13419,184617
2020-09-08,16:30:00,124570,15556,17915,12946,4790,13996,189773
2020-09-08,17:00:00,125972,15222,19051,14622,4943,16607,196417
2020-09-08,17:30:00,123197,15166,20212,16188,4811,17175,196749
2020-09-08,18:00:00,125003,15070,19855,16171,6120,18466,200685
2020-09-08,18:30:00,121626,14912,20030,16477,4961,17918,195924
2020-09-08,19:00:00,127948,16232,20922,17975,4655,19316,207048
2020-09-08,19:30:00,129744,17595,21000,16773,5097,19476,209685
2020-09-08,20:00:00,128686,16756,19970,15736,5221,17530,203899
2020-09-08,20:30:00,125514,16214,20006,14766,4940,14970,196410
2020-09-08,21:00:00,121441,15650,17973,13135,4432,14423,187054
2020-09-08,21:30:00,118298,15642,18193,13671,4853,12265,182922
2020-09-08,22:00:00,116085,14840,17993,12758,4867,11726,178269
2020-09-08,22:30:00,114088,14083,16763,12269,4710,11285,173198
2020-09-08,23:00:00,114410,14257,16140,11824,4858,12458,173947
2020-09-08,23:30:00,111853,13373,16474,11098,4403,12227,169428
2020-09-09,00:00:00,109415,11758,13948,10725,3503,10837,160186
2020-09-09,00:30:00,105931,11837,14922,9595,3266,11570,157121
2020-09-09,01:00:00,95823,12111,15285,7733,2571,8049,141572
2020-09-09,01:30:00,92214,13364,14851,7593,2585,5389,135996
2020-09-09,02:00:00,86827,12771,12531,5999,2311,5161,125600
2020-09-09,02:30:00,81780,13375,12357,6093,1810,6119,121534
2020-09-09,03:00:00,84295,12916,11460,5521,1949,5733,121874
2020-09-09,03:30:00,82247,11840,10842,5975,1861,5642,118407
2020-09-09,04:00:00,82205,12470,11483,5497,1998,5119,118772
2020-09-09,04:30:00,82486,12404,11093,6384,2740,5290,120397
2020-09-09,05:00:00,82638,10366,8287,6219,2986,5384,115880
2020-09-09,05:30:00,83089,9562,7626,5823,2589,5366,114055
2020-09-09,06:00:00,84982,10159,7212,5606,2222,1839,112020
2020-09-09,06:30:00,98615,10009,9303,6779,1611,7395,133712
2020-09-09,07:00:00,98436,9186,11203,8177,1325,7390,135717
2020-09-09,07:30:00,106228,10923,12839,9751,2360,8847,150948
2020-09-09,08:00:00,117064,12184,14401,11442,2804,11456,169351
2020-09-09,08:30:00,121708,14446,16709,12400,3453,13569,182285
2020-09-09,09:00:00,129648,14949,17841,14331,3610,15698,196077
2020-09-09,09:30:00,130873,15825,20146,14328,4634,15529,201335
2020-09-09,10:00:00,125384,16000,17836,12142,4283,13591,189236
2020-09-09,10:30:00,126794,15495,17951,12463,4570,14418,191691
2020-09-09,11:00:00,123259,15136,18159,12178,4884,14595,188211
2020-09-09,11:30:00,122473,15798,18346,12670,4686,14360,188333
2020-09-09,12:00:00,123064,16133,18837,13500,4701,15068,191303
2020-09-09,12:30:00,129520,16920,19464,13922,5008,15409,200243
2020-09-09,13:00:00,131349,17950,22342,17467,4692,18012,211812
2020-09-09,13:30:00,132837,18266,22317,14181,5383,18209,211193
2020-09-09,14:00:00,128438,16755,21028,15439,4893,17264,203817
2020-09-09,14:30:00,128577,15868,19489,14361,5544,16177,200016
2020-09-09,15:00:00,127804,16387,19312,14768,5036,12731,196038
2020-09-09,15:30:00,129011,16936,19190,13620,4948,15290,198995
2020-09-09,16:00:00,122382,17576,21146,15049,5196,18277,199626
2020-09-09,16:30:00,128274,17216,19843,14126,5817,17547,202823
2020-09-09,17:00:00,126348,14926,19312,14748,4717,16347,196398
2020-09-09,17:30:00,121088,14552,18936,13958,4415,16394,189343
2020-09-09,18:00:00,123590,16012,20715,16404,5166,19092,200979
2020-09-09,18:30:00,133142,18800,23755,18499,6644,19765,220605
2020-09-09,19:00:00,129648,17982,22647,17782,6150,18155,212364
2020-09-09,19:30:00,134156,18394,22796,17383,6079,18619,217427
2020-09-09,20:00:00,127205,18300,21046,15409,5941,15488,203389
2020-09-09,20:30:00,126102,15807,18667,13186,5778,14107,193647
2020-09-09,21:00:00,125199,15683,17501,13625,5081,13973,191062
2020-09-09,21:30:00,122829,14461,16471,10651,5089,13108,182609
2020-09-09,22:00:00,118112,14397,15534,11261,4929,12496,176729
2020-09-09,22:30:00,115981,14536,16480,11029,5487,11956,175469
2020-09-09,23:00:00,116121,14247,16120,10820,4461,12528,174297
2020-09-09,23:30:00,115859,13221,14187,11098,3487,12572,170424
2020-09-10,00:00:00,113957,12368,13936,9981,3607,11077,164926
2020-09-10,00:30:00,115149,12951,13682,8908,3180,12496,166366
2020-09-10,01:00:00,107879,14634,13646,7944,2776,11534,158413
2020-09-10,01:30:00,102890,14128,11386,6538,2244,9929,147115
2020-09-10,02:00:00,97854,12707,11387,6003,2521,8050,138522
2020-09-10,02:30:00,93709,12502,11609,6183,2599,5876,132478
2020-09-10,03:00:00,90541,12095,10823,5567,3063,5311,127400
2020-09-10,03:30:00,86075,10609,9839,6263,3296,5433,121515
2020-09-10,04:00:00,88405,9243,6972,6124,2124,5363,118231
2020-09-10,04:30:00,87523,9156,6813,6197,3127,4976,117792
2020-09-10,05:00:00,85130,9644,6330,5589,3365,4892,114950
2020-09-10,05:30:00,85705,10047,7957,5633,2224,4511,116077
2020-09-10,06:00:00,87951,10186,7609,6534,1810,1383,115473
2020-09-10,06:30:00,99492,10337,10969,7644,1649,6324,136415
2020-09-10,07:00:00,99273,10162,12169,7632,2383,7066,138685
2020-09-10,07:30:00,108682,10329,11921,8441,2484,8067,149924
2020-09-10,08:00:00,118307,12508,14592,11162,3217,11159,170945
2020-09-10,08:30:00,129928,14415,16887,12974,3560,14218,191982
2020-09-10,09:00:00,133037,16570,19489,15543,5383,16693,206715
2020-09-10,09:30:00,133260,15994,20008,14649,5410,16332,205653
2020-09-10,10:00:00,130177,15468,17339,12564,4387,13680,193615
2020-09-10,10:30:00,125303,14234,17880,12733,4617,13679,188446
2020-09-10,11:00:00,127952,15609,18914,13351,4370,14021,194217
2020-09-10,11:30:00,127201,16374,18545,13039,4146,14858,194163
2020-09-10,12:00:00,124246,16020,19135,13051,5023,14707,192182
2020-09-10,12:30:00,128911,16971,20810,14486,5435,16453,203066
2020-09-10,13:00:00,129672,16336,21170,15546,5055,16932,204711
2020-09-10,13:30:00,129132,17221,21142,15476,5069,16756,204796
2020-09-10,14:00:00,111440,14493,17218,12405,4382,13408,173346
2020-09-10,14:30:00,128803,15833,19460,13430,5766,15538,198830
2020-09-10,15:00:00,127636,15736,18968,13201,5663,14390,195594
2020-09-10,15:30:00,126921,16023,18837,13615,5614,15372,196382
2020-09-10,16:00:00,125811,15693,18944,13288,5150,15034,193920
2020-09-10,16:30:00,127078,15915,20174,15157,5264,16597,200185
2020-09-10,17:00:00,126258,16022,21171,16375,5562,18963,204351
2020-09-10,17:30:00,126509,16417,20264,16182,5828,17587,202787
2020-09-10,18:00:00,125312,17139,21529,17817,5642,19256,206695
2020-09-10,18:30:00,130085,17887,22373,17750,6569,18669,213333
2020-09-10,19:00:00,127764,16971,22251,17117,6198,19370,209671
2020-09-10,19:30:00,128177,16760,20578,16000,5806,17152,204473
2020-09-10,20:00:00,127039,15662,19202,14970,4783,15863,197519
2020-09-10,20:30:00,124241,15624,18694,13599,5126,13662,190946
2020-09-10,21:00:00,124498,15611,19382,13615,5294,13412,191812
2020-09-10,21:30:00,120950,14375,17896,13085,4674,12397,183377
2020-09-10,22:00:00,118405,14575,17553,13201,4757,12692,181183
2020-09-10,22:30:00,118594,15759,16613,11534,5175,11958,179633
2020-09-10,23:00:00,116821,15338,16430,11683,4688,11837,176797
2020-09-10,23:30:00,115329,14212,15376,11172,3858,11513,171460
2020-09-11,00:00:00,117120,15280,15067,10334,4427,12271,174499
2020-09-11,00:30:00,116728,14408,14792,9242,4569,11451,171190
2020-09-11,01:00:00,108381,13355,12967,8409,3935,10711,157758
2020-09-11,01:30:00,100825,14249,14257,9422,3556,8794,151103
2020-09-11,02:00:00,100566,15893,15749,8185,3982,4580,148955
2020-09-11,02:30:00,97230,14243,13888,6017,3787,1023,136188
2020-09-11,03:00:00,92622,13169,12561,5939,2523,894,127708
2020-09-11,03:30:00,90012,11668,11755,5975,2047,991,122448
2020-09-11,04:00:00,84844,8605,7899,6787,1898,936,110969
2020-09-11,04:30:00,82984,8775,7689,6754,1609,1079,108890
2020-09-11,05:00:00,80577,9148,7959,6917,1700,997,107298
2020-09-11,05:30:00,81057,9588,8537,7381,1976,1140,109679
2020-09-11,06:00:00,80081,10514,8760,7432,2057,1572,110416
2020-09-11,06:30:00,97335,10907,11590,8604,1722,6613,136771
2020-09-11,07:00:00,99653,10146,12257,9022,1776,7725,140579
2020-09-11,07:30:00,106854,10215,12515,9979,2056,9341,150960
2020-09-11,08:00:00,117327,13065,15217,11244,3543,11732,172128
2020-09-11,08:30:00,124996,13910,15807,11905,3575,13268,183461
2020-09-11,09:00:00,130441,16263,17733,13228,4772,15746,198183
2020-09-11,09:30:00,129769,17656,21020,15139,5583,16700,205867
2020-09-11,10:00:00,127014,16190,18035,12011,5077,14033,192360
2020-09-11,10:30:00,122747,15393,17631,12540,4549,13625,186485
2020-09-11,11:00:00,124719,15987,17766,12340,4655,14004,189471
2020-09-11,11:30:00,123103,15016,17097,12307,4555,14278,186356
2020-09-11,12:00:00,123324,14899,16448,12303,4405,14463,185842
2020-09-11,12:30:00,124368,16361,18010,13179,5556,14490,191964
2020-09-11,13:00:00,124397,17320,19120,14591,4653,15363,195444
2020-09-11,13:30:00,117726,15855,17459,13085,4454,14227,182806
2020-09-11,14:00:00,123622,16936,19257,14143,4803,15818,194579
2020-09-11,14:30:00,122257,16091,17724,12054,4780,13633,186539
2020-09-11,15:00:00,122024,15986,17355,12704,4939,14276,187284
2020-09-11,15:30:00,124655,16730,17435,13403,4624,14702,191549
2020-09-11,16:00:00,122988,17439,19443,14321,5445,15727,195363
2020-09-11,16:30:00,123192,16353,19600,15473,5745,16835,197198
2020-09-11,17:00:00,126481,16507,21451,17025,5041,18106,204611
2020-09-11,17:30:00,124344,16130,20142,15623,5114,17521,198874
2020-09-11,18:00:00,130558,18696,22654,17162,5959,18227,213256
2020-09-11,18:30:00,128390,18950,23247,17977,5330,18911,212805
2020-09-11,19:00:00,134034,18610,23595,18194,5736,18495,218664
2020-09-11,19:30:00,128583,18060,23212,17539,4749,18474,210617
2020-09-11,20:00:00,126762,18039,21904,16337,5206,16779,205027
2020-09-11,20:30:00,122918,15972,19776,15606,4642,15538,194452
2020-09-11,21:00:00,123883,16443,19861,13625,4580,14652,193044
2020-09-11,21:30:00,121647,16277,19127,13530,4682,14154,189417
2020-09-11,22:00:00,119901,14887,18141,13021,4627,13314,183891
2020-09-11,22:30:00,114410,15258,17601,12519,3470,12101,175359
2020-09-11,23:00:00,114343,13622,15636,11353,4310,11997,171261
2020-09-11,23:30:00,112297,13247,14951,11089,4148,11790,167522
2020-09-12,00:00:00,112888,12299,14576,10734,3092,12419,166008
2020-09-12,00:30:00,112338,12868,15088,9652,4178,11211,165335
2020-09-12,01:00:00,100085,10495,11372,7804,2752,10493,143001
2020-09-12,01:30:00,93459,12469,14133,7286,4183,8810,140340
2020-09-12,02:00:00,90704,13301,14339,6654,3522,4268,132788
2020-09-12,02:30:00,87939,13307,14514,6678,3286,1126,126850
2020-09-12,03:00:00,85164,14808,15005,6417,3198,1063,125655
2020-09-12,03:30:00,81660,15074,14103,6024,2771,857,120489
2020-09-12,04:00:00,78168,15587,13912,6062,1881,1055,116665
2020-09-12,04:30:00,72826,15049,13685,6680,1625,1028,110893
2020-09-12,05:00:00,79538,13323,12246,7240,1907,817,115071
2020-09-12,05:30:00,80041,10541,8438,6920,2137,834,108911
2020-09-12,06:00:00,80760,10196,8555,7362,1933,770,109576
2020-09-12,06:30:00,86199,10802,11628,7171,2174,5710,123684
2020-09-12,07:00:00,89182,10271,10235,6357,2240,5674,123959
2020-09-12,07:30:00,92205,10033,10805,6130,2013,6086,127272
2020-09-12,08:00:00,94919,10210,11681,6871,2752,7372,133805
2020-09-12,08:30:00,99469,10707,11956,7606,2943,7279,139960
2020-09-12,09:00:00,103370,12282,13449,9186,3404,9710,151401
2020-09-12,09:30:00,107589,12121,14321,10500,3114,10798,158443
2020-09-12,10:00:00,112486,12009,15743,12045,3252,11365,166900
2020-09-12,10:30:00,114771,12737,16575,12869,4335,12027,173314
2020-09-12,11:00:00,119079,14956,18398,11962,4481,13927,182803
2020-09-12,11:30:00,119187,15229,20244,11293,4549,14899,185401
2020-09-12,12:00:00,122628,15662,19983,15605,4836,15473,194187
2020-09-12,12:30:00,123516,15323,19218,15490,4615,16815,194977
2020-09-12,13:00:00,121185,16781,18690,15042,4712,15132,191542
2020-09-12,13:30:00,121977,16380,17838,13084,4649,13643,187571
2020-09-12,14:00:00,118554,15169,18084,13779,4868,13438,183892
2020-09-12,14:30:00,119259,15886,18115,13630,4633,13312,184835
2020-09-12,15:00:00,117738,15459,19064,14502,5105,14672,186540
2020-09-12,15:30:00,117377,14730,19466,15538,5197,15043,187351
2020-09-12,16:00:00,116787,13862,18560,14405,5278,14321,183213
2020-09-12,16:30:00,112128,13493,16989,13366,4755,14066,174797
2020-09-12,17:00:00,113653,13895,18298,14299,5084,15107,180336
2020-09-12,17:30:00,114529,13848,17843,14281,5323,14971,180795
2020-09-12,18:00:00,114624,14133,17225,13725,5517,15230,180454
2020-09-12,18:30:00,117853,14021,19212,15465,5433,16253,188237
2020-09-12,19:00:00,127002,15283,20363,16230,4788,16428,200094
2020-09-12,19:30:00,119383,15901,20788,15934,5743,15684,193433
2020-09-12,20:00:00,120174,14464,20324,15550,5262,16067,191841
2020-09-12,20:30:00,124448,15620,19573,14854,5320,15484,195299
2020-09-12,21:00:00,120080,14980,19922,14196,5104,14912,189194
2020-09-12,21:30:00,118996,14758,18605,13240,4585,13042,183226
2020-09-12,22:00:00,116882,14848,17802,12323,4298,11954,178107
2020-09-12,22:30:00,117286,14846,17194,11526,4635,12295,177782
2020-09-12,23:00:00,116368,13884,16069,11903,4504,13123,175851
2020-09-12,23:30:00,115130,13719,16455,11244,4547,11556,172651
2020-09-13,00:00:00,115753,15385,14665,10408,4235,12301,172747
2020-09-13,00:30:00,119770,14987,14719,10116,3141,11593,174326
2020-09-13,01:00:00,109534,14706,15338,7979,2705,11367,161629
2020-09-13,01:30:00,106822,14195,14007,8628,1363,10705,155720
2020-09-13,02:00:00,103484,15100,15000,8295,2157,9691,153727
2020-09-13,02:30:00,100405,14868,14256,6617,2554,4786,143486
2020-09-13,03:00:00,95447,13975,13724,6621,1760,4194,135721
2020-09-13,03:30:00,92032,13517,13045,5918,1426,802,126740
2020-09-13,04:00:00,89443,13062,13604,6997,1357,570,125033
2020-09-13,04:30:00,79223,12519,13100,6600,1250,783,113475
2020-09-13,05:00:00,78533,11905,11474,6592,1824,793,111121
2020-09-13,05:30:00,78480,9295,7960,6715,1900,826,105176
2020-09-13,06:00:00,77334,10134,7790,6675,1924,933,104790
2020-09-13,06:30:00,85863,10579,10343,6943,1632,5737,121097
2020-09-13,07:00:00,84979,8924,10316,6197,1694,5838,117948
2020-09-13,07:30:00,85354,10234,9740,6141,2128,6264,119861
2020-09-13,08:00:00,88470,9264,11277,6914,2089,7187,125201
2020-09-13,08:30:00,91557,10127,11100,6794,3395,7405,130378
2020-09-13,09:00:00,94764,9645,10641,7356,2595,8016,133017
2020-09-13,09:30:00,100566,10293,11736,8590,2604,8328,142117
2020-09-13,10:00:00,105344,12154,14653,12011,3421,13023,160606
2020-09-13,10:30:00,111810,14452,15741,12254,3868,13074,171199
2020-09-13,11:00:00,114026,14667,16116,10949,3513,11325,170596
2020-09-13,11:30:00,107520,13963,15827,11293,4146,12466,165215
2020-09-13,12:00:00,120969,17361,20508,14435,4284,14624,192181
2020-09-13,12:30:00,121941,16490,19577,14115,4850,13320,190293
2020-09-13,13:00:00,121528,16793,19301,13507,4703,12829,188661
2020-09-13,13:30:00,119879,15048,17705,12511,4620,12018,181781
2020-09-13,14:00:00,117972,14598,16915,11693,3807,12103,177088
2020-09-13,14:30:00,114817,15575,17666,12593,5072,11371,177094
2020-09-13,15:00:00,108872,13742,16295,11782,4467,12731,167889
2020-09-13,15:30:00,113654,13580,16595,11477,4314,14159,173779
2020-09-13,16:00:00,114246,13627,16479,11743,5003,11919,173017
2020-09-13,16:30:00,113812,14387,16171,10826,5404,11880,172480
2020-09-13,17:00:00,112589,13833,16335,11836,5419,12499,172511
2020-09-13,17:30:00,113940,14622,17107,12096,6371,12641,176777
2020-09-13,18:00:00,116440,14758,17685,12227,5643,13084,179837
2020-09-13,18:30:00,120745,15626,19183,13412,5137,13816,187919
2020-09-13,19:00:00,124530,14829,18446,16717,5759,17758,198039
2020-09-13,19:30:00,123917,14492,18918,14783,4974,14745,191829
2020-09-13,20:00:00,127271,15564,19329,14110,5773,15990,198037
2020-09-13,20:30:00,125140,15166,18659,12894,5627,13175,190661
2020-09-13,21:00:00,126999,15270,18929,13496,5773,14136,194603
2020-09-13,21:30:00,127445,13931,17467,12810,4964,13072,189689
2020-09-13,22:00:00,118655,13994,16029,11966,4239,13178,178061
2020-09-13,22:30:00,121708,13056,16656,11328,3636,12095,178479
2020-09-13,23:00:00,116475,12782,15092,10549,3791,12527,171216
2020-09-13,23:30:00,114814,13325,14571,10799,3983,12465,169957
2020-09-14,00:00:00,117394,13922,13758,10270,3375,12077,170796
2020-09-14,00:30:00,115259,12150,14659,9372,3118,12145,166703
2020-09-14,01:00:00,102183,12627,14554,6954,2580,11244,150142
2020-09-14,01:30:00,99393,12733,14037,7097,1952,9473,144685
2020-09-14,02:00:00,94440,12243,14749,6094,1845,8910,138281
2020-09-14,02:30:00,90359,13800,13906,6099,3224,3150,130538
2020-09-14,03:00:00,82623,12480,13068,6211,2557,909,117848
2020-09-14,03:30:00,83209,12120,12064,6228,1696,646,115963
2020-09-14,04:00:00,82541,11620,11440,5855,2189,777,114422
2020-09-14,04:30:00,82752,11934,11541,5667,997,735,113626
2020-09-14,05:00:00,80851,13213,13041,6451,1822,1038,116416
2020-09-14,05:30:00,80924,13597,13835,7040,1685,1517,118598
2020-09-14,06:00:00,81532,11410,9275,7188,1952,2149,113506
2020-09-14,06:30:00,97489,11470,13060,8270,2202,7525,140016
2020-09-14,07:00:00,101308,9962,12459,8898,2154,8349,143130
2020-09-14,07:30:00,110182,11615,12991,9325,3364,9024,156501
2020-09-14,08:00:00,117788,12370,15106,11609,3371,12097,172341
2020-09-14,08:30:00,126994,12802,16314,13185,4672,13448,187415
2020-09-14,09:00:00,131889,16231,18576,15226,4412,16060,202394
2020-09-14,09:30:00,135993,15856,18479,14551,5412,16378,206669
2020-09-14,10:00:00,133772,15636,17397,12861,5187,14508,199361
2020-09-14,10:30:00,130255,14288,16557,11713,4386,13897,191096
2020-09-14,11:00:00,128072,14713,17288,12326,4724,14812,191935
2020-09-14,11:30:00,122304,15033,16519,11067,4714,13434,183071
2020-09-14,12:00:00,124457,15535,17296,12665,4712,14604,189269
2020-09-14,12:30:00,126932,15203,16728,13445,4268,14577,191153
2020-09-14,13:00:00,131334,15501,18420,14440,4596,16164,200455
2020-09-14,13:30:00,129038,15024,18547,15205,4942,16227,198983
2020-09-14,14:00:00,131679,15967,19519,15459,4688,16658,203970
2020-09-14,14:30:00,131978,16021,20137,15296,5360,16131,204923
2020-09-14,15:00:00,129219,15324,19140,14245,4974,16466,199368
2020-09-14,15:30:00,128248,15508,18706,13554,4955,15055,196026
2020-09-14,16:00:00,133139,14979,18972,14144,5038,15660,201932
2020-09-14,16:30:00,130844,15504,19436,14912,4797,16209,201702
2020-09-14,17:00:00,130988,16321,19199,15124,5154,17871,204657
2020-09-14,17:30:00,133054,16205,21300,17060,5288,19323,212230
2020-09-14,18:00:00,131590,16190,20231,16682,5558,18090,208341
2020-09-14,18:30:00,137853,18025,23527,19603,5857,22293,227158
2020-09-14,19:00:00,140089,17574,24531,19995,6326,21011,229526
2020-09-14,19:30:00,137828,18314,23214,18714,6175,19838,224083
2020-09-14,20:00:00,133606,17839,22794,16765,6075,17352,214431
2020-09-14,20:30:00,135395,17081,20709,15954,5412,16596,211147
2020-09-14,21:00:00,131466,17293,20017,13907,5781,15348,203812
2020-09-14,21:30:00,123831,16443,19253,13297,5523,13662,192009
2020-09-14,22:00:00,120118,15567,17925,12318,4684,12783,183395
2020-09-14,22:30:00,121679,15367,17720,11856,5107,11543,183272
2020-09-14,23:00:00,120861,14205,16401,11521,5013,12353,180354
2020-09-14,23:30:00,118591,13648,15951,10746,4454,12105,175495
2020-09-15,00:00:00,119027,14208,14860,9718,4619,10043,172475
2020-09-15,00:30:00,114069,13231,14504,8715,4347,11733,166599
2020-09-15,01:00:00,104195,12019,12827,7485,2819,8831,148176
2020-09-15,01:30:00,95547,11144,12757,6810,1979,9411,137648
2020-09-15,02:00:00,90959,12935,13921,7058,2878,6354,134105
2020-09-15,02:30:00,92115,13945,13688,6669,2737,1234,130388
2020-09-15,03:00:00,89190,13729,12937,6262,2243,1012,125373
2020-09-15,03:30:00,88044,13042,12532,5952,2033,895,122498
2020-09-15,04:00:00,86216,11147,9301,6630,2442,705,116441
2020-09-15,04:30:00,84643,9122,8338,7080,2333,1164,112680
2020-09-15,05:00:00,84222,9259,7981,6599,2330,983,111374
2020-09-15,05:30:00,83511,9297,7351,6356,2223,1878,110616
2020-09-15,06:00:00,83676,9920,8354,6932,2044,1931,112857
2020-09-15,06:30:00,97283,10843,11823,8258,2672,7081,137960
2020-09-15,07:00:00,102496,9503,11580,8708,2437,7650,142374
2020-09-15,07:30:00,111197,11151,13526,10111,3393,9824,159202
2020-09-15,08:00:00,121944,12845,15819,12481,3535,11938,178562
2020-09-15,08:30:00,127617,13863,16996,13639,4494,14261,190870
2020-09-15,09:00:00,133095,15715,19427,15108,5712,16095,205152
2020-09-15,09:30:00,131330,16674,19774,14607,5917,16231,204533
2020-09-15,10:00:00,130468,14860,17418,13488,4282,15979,196495
2020-09-15,10:30:00,125871,14535,17260,12706,4265,14563,189200
2020-09-15,11:00:00,126017,13585,17753,12826,4320,13899,188400
2020-09-15,11:30:00,128932,13781,17556,13007,4840,15106,193222
2020-09-15,12:00:00,124154,13202,16063,12350,4846,14679,185294
2020-09-15,12:30:00,127679,14867,17973,14151,4296,16416,195382
2020-09-15,13:00:00,131746,15624,19775,15063,4928,17029,204165
2020-09-15,13:30:00,132913,15328,18735,15082,4862,17327,204247
2020-09-15,14:00:00,127549,15071,18663,14272,4952,15733,196240
2020-09-15,14:30:00,121857,15296,18028,12774,4608,15475,188038
2020-09-15,15:00:00,116165,15522,17393,11276,5148,15217,180721
2020-09-15,15:30:00,110474,15748,16759,12792,3920,14959,174652
2020-09-15,16:00:00,104782,15974,16124,13220,4910,14701,169711
2020-09-15,16:30:00,99091,16200,15490,13129,4821,14443,163174
2020-09-15,17:00:00,130460,15496,20448,16862,5074,17457,205797
2020-09-15,17:30:00,131478,14212,18520,14944,4730,17978,201862
2020-09-15,18:00:00,136439,17204,22230,17871,5106,20710,219560
2020-09-15,18:30:00,136200,17526,22002,18274,5390,20682,220074
2020-09-15,19:00:00,135579,18387,23287,18449,5781,20304,221787
2020-09-15,19:30:00,134749,18229,24752,18957,6140,20187,223014
2020-09-15,20:00:00,134116,17176,22147,17251,5882,16986,213558
2020-09-15,20:30:00,132197,17384,21318,15284,5244,15380,206807
2020-09-15,21:00:00,128494,17390,20976,14230,5526,14301,200917
2020-09-15,21:30:00,123093,16789,19806,12615,5709,13752,191764
2020-09-15,22:00:00,123673,15442,18585,13238,4710,13635,189283
2020-09-15,22:30:00,123658,14006,16674,11678,4464,12726,183206
2020-09-15,23:00:00,121496,15028,17535,12455,4845,12336,183695
2020-09-15,23:30:00,120775,13749,16502,11031,5060,12014,179131
2020-09-16,00:00:00,120798,13646,16689,11309,3845,11403,177690
2020-09-16,00:30:00,115458,13700,15155,9987,3585,11877,169762
2020-09-16,01:00:00,102506,9985,11188,7497,2646,11941,145763
2020-09-16,01:30:00,95644,10381,13770,6657,2441,11040,139933
2020-09-16,02:00:00,94954,13637,14253,6018,2872,9788,141522
2020-09-16,02:30:00,90914,15098,15339,6510,2904,4261,135026
2020-09-16,03:00:00,87666,14361,14642,6207,2836,4152,129864
2020-09-16,03:30:00,86693,12785,12740,5862,2217,4496,124793
2020-09-16,04:00:00,86218,12983,12737,5724,2289,1348,121299
2020-09-16,04:30:00,84987,11844,11932,6743,3158,1346,120010
2020-09-16,05:00:00,84228,10391,9505,7700,2178,806,114808
2020-09-16,05:30:00,82710,9787,8779,8004,1367,777,111424
2020-09-16,06:00:00,86519,10627,8968,8044,1456,1096,116710
2020-09-16,06:30:00,101377,11570,12249,8802,1781,6668,142447
2020-09-16,07:00:00,105155,9725,11585,8243,1880,7691,144279
2020-09-16,07:30:00,102830,10185,11532,7613,2268,8076,142504
2020-09-16,08:00:00,114448,11821,13864,9880,2463,10460,162936
2020-09-16,08:30:00,127543,13835,17361,12981,3670,14863,190253
2020-09-16,09:00:00,134772,16180,18363,14005,4510,15802,203632
2020-09-16,09:30:00,132712,16773,19609,13934,4702,16288,204018
2020-09-16,10:00:00,132404,17168,20562,13933,4928,16220,205215
2020-09-16,10:30:00,132032,16564,18006,12336,4335,15227,198500
2020-09-16,11:00:00,130492,15870,18064,12692,4342,15170,196630
2020-09-16,11:30:00,133787,15719,19217,13272,5409,15780,203184
2020-09-16,12:00:00,136234,17247,20698,14885,6009,17193,212266
2020-09-16,12:30:00,139228,17682,21746,15573,5442,17562,217233
2020-09-16,13:00:00,135799,18381,21882,16217,6175,18573,217027
2020-09-16,13:30:00,138950,17961,19059,16383,5370,17255,214978
2020-09-16,14:00:00,132427,18111,21043,14431,4916,16785,207713
2020-09-16,14:30:00,128305,17368,20305,14148,4992,15458,200576
2020-09-16,15:00:00,127120,17765,20549,14839,5148,15672,201093
2020-09-16,15:30:00,131067,17107,20102,13453,4787,14406,200922
2020-09-16,16:00:00,132118,17231,20295,14253,4910,16097,204904
2020-09-16,16:30:00,129873,18036,20257,15199,5065,15157,203587
2020-09-16,17:00:00,131550,17632,20984,15979,5000,15938,207083
2020-09-16,17:30:00,130809,17348,21809,17529,5182,18037,210714
2020-09-16,18:00:00,128347,16914,20030,15816,5049,16720,202876
2020-09-16,18:30:00,127706,16661,19604,15345,4966,16286,200568
2020-09-16,19:00:00,127065,16408,19179,14874,5977,15852,199355
2020-09-16,19:30:00,126425,16156,18754,17150,4802,15418,198705
2020-09-16,20:00:00,125784,15903,18328,13932,4720,14984,193651
2020-09-16,20:30:00,125144,15651,17903,13461,4638,14550,191347
2020-09-16,21:00:00,124503,15398,17478,12991,4556,14116,189042
2020-09-16,21:30:00,123862,15145,17052,12520,4473,13682,186734
2020-09-16,22:00:00,123222,14893,16627,12049,4391,13248,184430
2020-09-16,22:30:00,122581,14640,16202,11578,4309,12814,182124
2020-09-16,23:00:00,121941,14388,15776,11107,4227,12380,179819
2020-09-16,23:30:00,121300,14135,16709,10636,4145,11946,178871
2020-09-18,00:00:00,120660,13883,14926,10166,4063,11512,175210
2020-09-18,00:30:00,117797,14334,16316,9566,3678,12489,174180
2020-09-18,01:00:00,107617,13333,14206,6567,2708,11440,155871
2020-09-18,01:30:00,103107,13352,13560,6233,2090,9058,147400
2020-09-18,02:00:00,98911,16364,15604,6283,3802,6555,147519
2020-09-18,02:30:00,91736,13800,14453,6472,3641,1656,131758
2020-09-18,03:00:00,89462,13757,14266,6238,3625,1413,128761
2020-09-18,03:30:00,86872,9844,10126,4450,2443,886,114621
2020-09-18,04:00:00,85265,10395,10591,4753,2241,896,114141
2020-09-18,04:30:00,83254,11119,9934,4111,2245,779,111442
2020-09-18,05:00:00,81841,11102,5625,6084,1191,936,106779
2020-09-18,05:30:00,81505,11002,5667,6323,1355,896,106748
2020-09-18,06:00:00,82050,11688,6258,6628,1775,1085,109484
2020-09-18,06:30:00,94688,9879,11471,8052,1912,5498,131500
2020-09-18,07:00:00,97985,7880,11155,6829,1902,6869,132620
2020-09-18,07:30:00,85193,9077,10274,7631,2491,8114,122780
2020-09-18,08:00:00,93584,10135,11154,7670,3235,8807,134585
2020-09-18,08:30:00,103462,12081,13865,10188,4174,11935,155705
2020-09-18,09:00:00,109204,13930,15914,11641,4222,13855,168766
2020-09-18,09:30:00,109882,15858,16617,11881,5566,13971,173775
2020-09-18,10:00:00,111894,13915,15516,12024,4907,12282,170538
2020-09-18,10:30:00,111402,15023,16537,11632,4728,12438,171760
2020-09-18,11:00:00,123820,14814,17352,12593,4854,13633,187066
2020-09-18,11:30:00,124801,14570,16540,10513,4629,12541,183594
2020-09-18,12:00:00,125403,14354,16273,12068,4474,12986,185558
2020-09-18,12:30:00,128368,15385,16663,11075,5076,13258,189825
2020-09-18,13:00:00,128750,15971,17357,13163,5726,13999,194966
2020-09-18,13:30:00,111594,16109,17379,12544,5363,13159,176148
2020-09-18,14:00:00,110969,15311,16955,12165,5041,12063,172504
2020-09-18,14:30:00,125893,14866,16336,12049,4816,12741,186701
2020-09-18,15:00:00,109932,14821,16743,12086,4997,12135,170714
2020-09-18,15:30:00,111849,14771,16762,12075,4683,12751,172891
2020-09-18,16:00:00,111769,16012,16644,12574,5126,13190,175315
2020-09-18,16:30:00,106034,15942,16629,12235,5270,13083,169193
2020-09-18,17:00:00,109292,15516,17863,14056,5073,14911,176711
2020-09-18,17:30:00,116917,15403,19468,15030,4594,15924,187336
2020-09-18,18:00:00,120095,16268,21124,16578,5369,17469,196903
2020-09-18,18:30:00,124745,17480,22568,18460,5894,19873,209020
2020-09-18,19:00:00,128978,18888,23327,18970,5977,19839,215979
2020-09-18,19:30:00,127031,19058,22520,17295,5897,17776,209577
2020-09-18,20:00:00,125056,17016,20596,15087,5596,15450,198801
2020-09-18,20:30:00,121082,15642,20424,16155,5657,16459,195419
2020-09-18,21:00:00,121992,14567,17392,13617,4947,14255,186770
2020-09-18,21:30:00,122241,14374,17549,13580,5287,14039,187070
2020-09-18,22:00:00,119260,14471,17999,13971,5132,14295,185128
2020-09-18,22:30:00,113904,14150,15902,10918,4341,10999,170214
2020-09-18,23:00:00,117844,13654,15918,12631,4330,12608,176985
2020-09-18,23:30:00,120444,14066,16529,13207,4852,12053,181151
2020-09-19,00:00:00,119443,13785,15998,12177,4500,12233,178136
2020-09-19,00:30:00,114354,14492,17286,11077,4740,11175,173124
2020-09-19,01:00:00,108170,12054,12844,6489,2786,10341,152684
2020-09-19,01:30:00,106505,13867,13405,6770,3969,7279,151795
2020-09-19,02:00:00,105871,14113,14258,7139,3780,4608,149769
2020-09-19,02:30:00,99956,14869,13058,5899,3495,4840,142117
2020-09-19,03:00:00,97650,16916,13797,6315,3435,4195,142308
2020-09-19,03:30:00,92135,16093,14377,6297,3469,3939,136310
2020-09-19,04:00:00,89874,15581,14466,6566,2189,828,129504
2020-09-19,04:30:00,86113,14405,13387,5775,2998,1017,123695
2020-09-19,05:00:00,86352,13963,11424,5105,1230,901,118975
2020-09-19,05:30:00,87973,13183,10252,6183,1856,851,120298
2020-09-19,06:00:00,87778,10740,7783,6600,2093,779,115773
2020-09-19,06:30:00,91871,10369,10740,7521,1532,5577,127610
2020-09-19,07:00:00,92432,8618,10044,7250,1768,5124,125236
2020-09-19,07:30:00,94238,9496,10907,7594,2358,5984,130577
2020-09-19,08:00:00,98819,10338,11556,8592,2933,7190,139428
2020-09-19,08:30:00,103726,11199,13003,9687,3005,8443,149063
2020-09-19,09:00:00,110973,12652,15024,11394,3506,9567,163116
2020-09-19,09:30:00,115741,13392,18067,13308,3627,11709,175844
2020-09-19,10:00:00,118067,15473,19521,13593,4708,12395,183757
2020-09-19,10:30:00,120312,16368,19564,14205,4853,13205,188507
2020-09-19,11:00:00,122679,16751,17753,12826,4924,14882,189815
2020-09-19,11:30:00,123776,15564,21174,13114,5060,16408,195096
2020-09-19,12:00:00,126940,18207,22068,17226,5904,16914,207259
2020-09-19,12:30:00,128917,18991,21415,17535,5617,16162,208637
2020-09-19,13:00:00,125517,18753,22083,17639,5898,16944,206834
2020-09-19,13:30:00,120746,16839,20123,15546,4611,15750,193615
2020-09-19,14:00:00,124149,16708,20057,15540,4627,15033,196114
2020-09-19,14:30:00,126453,18902,20972,15455,4887,15205,201874
2020-09-19,15:00:00,124356,18256,20238,15431,5086,16311,199678
2020-09-19,15:30:00,121725,17853,20192,15018,4867,15193,194848
2020-09-19,16:00:00,121305,17960,20943,13220,4852,16584,194864
2020-09-19,16:30:00,117547,16727,20952,16300,4451,15155,191132
2020-09-19,17:00:00,118269,16793,20990,15489,4580,15126,191247
2020-09-19,17:30:00,119845,17115,21101,15880,5494,15783,195218
2020-09-19,18:00:00,120564,17230,22019,16496,5970,17267,199546
2020-09-19,18:30:00,123498,17604,22357,17929,5047,17694,204129
2020-09-19,19:00:00,127297,17323,21963,16776,5868,16644,205871
2020-09-19,19:30:00,128274,16742,20925,16867,5191,17534,205533
2020-09-19,20:00:00,128493,17427,20845,16179,5484,15289,203717
2020-09-19,20:30:00,125376,15653,18942,14038,4759,13006,191774
2020-09-19,21:00:00,124573,16674,20454,15039,5314,13607,195661
2020-09-19,21:30:00,124201,14850,18506,14105,4365,13662,189689
2020-09-19,22:00:00,121055,15580,17569,12855,4291,12806,184156
2020-09-19,22:30:00,122172,15351,17582,12358,4227,12040,183730
2020-09-19,23:00:00,122330,16372,18727,13053,4422,11132,186036
2020-09-19,23:30:00,122860,16378,16709,13690,5266,11853,186756
2020-09-20,00:00:00,122253,13922,18111,12190,4454,10941,181871
2020-09-20,00:30:00,122084,15261,17440,11323,5250,11739,183097
2020-09-20,01:00:00,115995,16142,17291,7387,3226,11106,171147
2020-09-20,01:30:00,113783,15281,13770,6971,4219,7496,161520
2020-09-20,02:00:00,109049,14512,14749,6775,3972,5667,154724
2020-09-20,02:30:00,100444,15432,14458,6525,4335,5576,146770
2020-09-20,03:00:00,98831,16853,16797,7483,4171,4723,148858
2020-09-20,03:30:00,97842,16447,16669,8017,3444,941,143360
2020-09-20,04:00:00,94728,14692,14476,7615,1990,749,134250
2020-09-20,04:30:00,83254,15572,15150,7988,1797,578,124339
2020-09-20,05:00:00,81841,15557,14106,7244,1841,714,121303
2020-09-20,05:30:00,90058,14626,12458,6848,2310,646,126946
2020-09-20,06:00:00,87611,11395,8529,7207,2266,477,117485
2020-09-20,06:30:00,95111,12329,11971,8101,2834,4777,135123
2020-09-20,07:00:00,96090,10009,12012,8192,2514,5859,134676
2020-09-20,07:30:00,96087,10076,11272,7735,2040,6178,133388
2020-09-20,08:00:00,98790,11199,11506,7758,2389,6266,137908
2020-09-20,08:30:00,102682,11494,12555,8904,2904,6474,145013
2020-09-20,09:00:00,105471,12051,12973,9506,3089,6399,149489
2020-09-20,09:30:00,110766,13260,14559,10589,3360,8371,160905
2020-09-20,10:00:00,115063,14047,15947,11399,3886,9851,170193
2020-09-20,10:30:00,115209,14949,16372,11455,4295,9944,172224
2020-09-20,11:00:00,120744,15830,17547,12782,4409,14025,185337
2020-09-20,11:30:00,123893,16275,19278,14331,4775,12173,190725
2020-09-20,12:00:00,128844,17337,20856,14572,4826,13334,199769
2020-09-20,12:30:00,129542,17081,20249,15243,4590,12939,199644
2020-09-20,13:00:00,126331,17237,19197,14224,4314,12763,194066
2020-09-20,13:30:00,122725,15852,17985,13263,4867,12134,186826
2020-09-20,14:00:00,122712,14488,17940,13813,4916,12906,186775
2020-09-20,14:30:00,125105,15904,18399,12655,4364,14557,190984
2020-09-20,15:00:00,125787,16107,18391,12707,4926,12029,189947
2020-09-20,15:30:00,125690,15454,18677,12923,4906,12165,189815
2020-09-20,16:00:00,128226,15858,19432,13553,4933,13025,195027
2020-09-20,16:30:00,125731,15539,19036,13320,5295,12911,191832
2020-09-20,17:00:00,126201,15981,19361,13276,5561,12827,193207
2020-09-20,17:30:00,127634,15365,18580,13593,5243,13801,194216
2020-09-20,18:00:00,130399,16200,19377,15074,5169,17689,203908
2020-09-20,18:30:00,134181,16736,20552,15934,5908,15143,208454
2020-09-20,19:00:00,135208,17320,21252,16297,5933,14514,210524
2020-09-20,19:30:00,137233,17605,20999,16598,6104,15859,214398
2020-09-20,20:00:00,138165,18413,20309,15193,5277,14391,211748
2020-09-20,20:30:00,136749,17880,21450,15219,5672,14380,211350
2020-09-20,21:00:00,137571,16890,19566,14818,5879,14703,209427
2020-09-20,21:30:00,135902,17078,19160,13901,5113,13745,204899
2020-09-20,22:00:00,135568,17689,19481,13903,4571,12973,204185
2020-09-20,22:30:00,130812,16340,17955,12288,5260,11331,193986
2020-09-20,23:00:00,130705,15285,16904,11636,4950,10844,190324
2020-09-20,23:30:00,128750,15895,16551,11481,4872,11666,189215
2020-09-21,00:00:00,121042,13971,16274,12894,3915,12397,180493
2020-09-21,00:30:00,122088,15520,15902,10937,3756,12665,180868
2020-09-21,01:00:00,112206,15265,14825,7688,4221,10628,164833
2020-09-21,01:30:00,110381,16254,14484,6383,3130,6360,156992
2020-09-21,02:00:00,105491,15766,14498,6125,3266,4429,149575
2020-09-21,02:30:00,101715,14838,13901,6237,2805,4464,143960
2020-09-21,03:00:00,101280,15562,14978,6680,1773,4034,144307
2020-09-21,03:30:00,92092,14015,13890,7763,1764,703,130227
2020-09-21,04:00:00,90038,14468,13554,7613,1883,737,128293
2020-09-21,04:30:00,86113,14701,15000,8301,1750,701,126566
2020-09-21,05:00:00,81210,12849,12309,9117,1900,714,118099
2020-09-21,05:30:00,83148,11538,10309,9396,1886,722,116999
2020-09-21,06:00:00,83734,11739,11057,6628,2052,1428,116638
2020-09-21,06:30:00,103876,13148,12300,8052,1972,6694,146042
2020-09-21,07:00:00,108760,11332,11827,8983,2213,8260,151375
2020-09-21,07:30:00,116609,11813,13261,10586,2733,9939,164941
2020-09-21,08:00:00,129204,14220,15248,12302,3443,12118,186535
2020-09-21,08:30:00,134475,15591,17206,13347,4018,15233,199870
2020-09-21,09:00:00,138351,16583,18491,14656,5582,16886,210549
2020-09-21,09:30:00,140655,17860,19693,15521,4530,18885,217144
2020-09-21,10:00:00,140227,17049,20281,15018,4797,16714,214086
2020-09-21,10:30:00,134186,17504,18602,13863,5141,15289,204585
2020-09-21,11:00:00,127459,15870,17950,12537,5577,14748,194141
2020-09-21,11:30:00,131640,15308,18021,13124,4886,15015,197994
2020-09-21,12:00:00,130687,15103,17924,13382,4766,14658,196520
2020-09-21,12:30:00,137000,17509,20431,15829,5875,17481,214125
2020-09-21,13:00:00,137710,17162,20147,16175,5636,17946,214776
2020-09-21,13:30:00,135122,16372,18689,14281,5018,15985,205467
2020-09-21,14:00:00,134851,16582,19471,15247,5226,17432,208809
2020-09-21,14:30:00,135627,16810,18231,14565,4896,15431,205560
2020-09-21,15:00:00,132774,16762,17219,13204,5233,14454,199646
2020-09-21,15:30:00,129956,14643,15966,12748,4271,14224,191808
2020-09-21,16:00:00,132282,15411,17424,13045,5026,14698,197886
2020-09-21,16:30:00,135924,16989,19335,13158,5640,15250,206296
2020-09-21,17:00:00,132050,16469,19455,14468,5673,16951,205066
2020-09-21,17:30:00,132563,17660,21217,16418,5995,18026,211879
2020-09-21,18:00:00,138012,17564,22746,18323,6225,19714,222584
2020-09-21,18:30:00,143327,17593,25515,21073,5722,21488,234718
2020-09-21,19:00:00,141391,18783,23265,18985,6047,18970,227441
2020-09-21,19:30:00,140576,18706,23206,17221,6141,18315,224165
2020-09-21,20:00:00,141079,18229,22722,16623,6545,16689,221887
2020-09-21,20:30:00,139572,18680,21974,15816,5964,15154,217160
2020-09-21,21:00:00,135788,17443,19907,14370,5173,14693,207374
2020-09-21,21:30:00,132980,17089,19164,13598,4956,13807,201594
2020-09-21,22:00:00,131658,17482,19135,13143,5294,12703,199415
2020-09-21,22:30:00,130047,17131,18353,12041,5044,11988,194604
2020-09-21,23:00:00,127693,16174,17184,12071,5377,11986,190485
2020-09-21,23:30:00,128503,14720,16221,11979,4693,12027,188143
2020-09-22,00:00:00,126834,15629,16846,12198,5026,11994,188527
2020-09-22,00:30:00,120760,14457,15307,10358,4154,11247,176283
2020-09-22,01:00:00,109717,12559,12986,4240,4047,8093,151642
2020-09-22,01:30:00,104622,8480,12568,7073,4252,7065,144060
2020-09-22,02:00:00,102452,14466,12677,5844,5480,664,141583
2020-09-22,02:30:00,96102,11478,13011,5742,4345,651,131329
2020-09-22,03:00:00,91387,9663,12597,5645,3798,3538,126628
2020-09-22,03:30:00,86628,11811,11074,5245,1262,3125,119145
2020-09-22,04:00:00,80328,11721,1429,1506,1003,1011,96998
2020-09-22,04:30:00,80053,11688,1747,410,957,410,95265
2020-09-22,05:00:00,79318,12564,8591,422,1520,422,102837
2020-09-22,05:30:00,79050,3085,3874,2363,955,1130,90457
2020-09-22,06:00:00,79455,2814,1780,2189,1452,1304,88994
2020-09-22,06:30:00,89714,10635,10237,7003,1719,5839,125147
2020-09-22,07:00:00,91994,9466,10119,7104,1811,6481,126975
2020-09-22,07:30:00,95384,10128,11202,8210,1143,7577,133644
2020-09-22,08:00:00,102023,10218,11616,8903,1991,1730,136481
2020-09-22,08:30:00,109528,3791,3303,1664,2135,3285,123706
2020-09-22,09:00:00,115059,4799,3995,2701,4410,4184,135148
2020-09-22,09:30:00,117691,9031,5945,12228,5946,4161,155002
2020-09-22,10:00:00,107754,17302,14544,10934,4956,12316,167806
2020-09-22,10:30:00,123938,13641,16669,12435,3874,13824,184381
2020-09-22,11:00:00,130167,15961,17773,13390,3988,14795,196074
2020-09-22,11:30:00,130250,15845,18585,13195,4997,15008,197880
2020-09-22,12:00:00,129854,16233,18190,13532,5344,15252,198405
2020-09-22,12:30:00,132846,17164,19723,16037,5761,17205,208736
2020-09-22,13:00:00,136951,17058,20889,16577,5659,16621,213755
2020-09-22,13:30:00,139397,17949,21261,17343,5898,18168,220016
2020-09-22,14:00:00,135015,17483,20667,16038,5813,16491,211507
2020-09-22,14:30:00,130582,16023,19456,14637,5810,15910,202418
2020-09-22,15:00:00,129856,15101,17845,14238,5250,14350,196640
2020-09-22,15:30:00,126762,15394,17350,13868,4634,15361,193369
2020-09-22,16:00:00,128777,16241,18831,14349,5817,15007,199022
2020-09-22,16:30:00,129394,16235,19923,15457,5455,16365,202829
2020-09-22,17:00:00,127764,16231,19920,16103,5374,16904,202296
2020-09-22,17:30:00,130579,16107,18730,16360,4755,17179,203710
2020-09-22,18:00:00,129235,15116,20867,17658,5071,17807,205754
2020-09-22,18:30:00,130003,15511,20397,16853,4848,16572,204184
2020-09-22,19:00:00,138942,17699,23912,19931,5972,20392,226848
2020-09-22,19:30:00,142063,18398,21734,17414,5929,17530,223068
2020-09-22,20:00:00,136227,17464,22103,18347,5598,17795,217534
2020-09-22,20:30:00,133709,16727,19554,15834,5604,15944,207372
2020-09-22,21:00:00,133227,16046,20057,15017,5744,14348,204439
2020-09-22,21:30:00,129573,17130,19951,14242,5477,12962,199335
2020-09-22,22:00:00,131041,16453,18895,13457,5073,12699,197618
2020-09-22,22:30:00,130532,17134,17981,12024,4623,11453,193747
2020-09-22,23:00:00,129749,16213,17944,11944,5122,11644,192616
2020-09-22,23:30:00,127552,15320,17737,11634,4923,10567,187733
2020-09-23,00:00:00,126116,14923,16205,10988,4923,10905,184060
2020-09-23,00:30:00,125226,15066,17491,10825,5727,10486,184821
2020-09-23,01:00:00,116840,13241,12986,10060,4960,8363,166450
2020-09-23,01:30:00,113797,16185,14703,7654,4728,8288,165355
2020-09-23,02:00:00,107981,16282,10700,5131,4276,9402,153772
2020-09-23,02:30:00,96845,17714,10677,4904,3440,9037,142617
2020-09-23,03:00:00,93120,17228,9820,5498,2836,8090,136592
2020-09-23,03:30:00,89347,16465,7993,5668,1646,3755,124874
2020-09-23,04:00:00,86746,15544,7598,269,1328,692,112177
2020-09-23,04:30:00,85399,15768,7406,255,1644,689,111161
2020-09-23,05:00:00,91646,17174,8070,304,1809,624,119627
2020-09-23,05:30:00,94451,17052,7886,264,1739,580,121972
2020-09-23,06:00:00,95308,17012,8365,436,1540,1000,123661
2020-09-23,06:30:00,106806,13527,11582,7107,2192,6627,147841
2020-09-23,07:00:00,112371,11581,12177,8053,2549,8031,154762
2020-09-23,07:30:00,119801,13298,15161,10189,2938,9501,170888
2020-09-23,08:00:00,126779,13704,14663,11097,2621,11471,180335
2020-09-23,08:30:00,133042,13846,16770,13447,3810,15186,196101
2020-09-23,09:00:00,138019,15639,19098,14236,4246,16500,207738
2020-09-23,09:30:00,139189,17230,19827,14860,4835,15373,211314
2020-09-23,10:00:00,139958,17294,18558,13017,5471,15316,209614
2020-09-23,10:30:00,130583,16607,16660,11237,5417,13461,193965
2020-09-23,11:00:00,127391,14540,17825,13228,5125,14295,192404
2020-09-23,11:30:00,131305,15870,18305,12498,4833,14069,196880
2020-09-23,12:00:00,124295,15756,18271,12244,4719,14261,189546
2020-09-23,12:30:00,130213,16212,19319,13748,5531,16310,201333
2020-09-23,13:00:00,135900,17991,20885,16331,5880,18026,215013
2020-09-23,13:30:00,136431,18523,22095,17235,6039,17891,218214
2020-09-23,14:00:00,132183,18090,20885,15493,5319,15795,207765
2020-09-23,14:30:00,128928,17214,19620,13513,5294,14514,199083
2020-09-23,15:00:00,133824,16779,19733,13276,5250,14709,203571
2020-09-23,15:30:00,129018,16644,19085,13637,5216,15305,198905
2020-09-23,16:00:00,125733,16029,18144,12094,4850,14028,190878
2020-09-23,16:30:00,129603,15915,18976,13946,5339,14476,198255
2020-09-23,17:00:00,133397,16101,20508,16334,5265,16943,208548
2020-09-23,17:30:00,132611,16848,21501,16655,6037,18077,211729
2020-09-23,18:00:00,130480,17118,21396,16285,6203,17805,209287
2020-09-23,18:30:00,135894,16620,21544,16915,6140,18455,215568
2020-09-23,19:00:00,139795,16414,20722,16314,5565,18217,217027
2020-09-23,19:30:00,142272,17005,21432,17337,5337,18683,222066
2020-09-23,20:00:00,136459,17681,21459,16530,5574,17590,215293
2020-09-23,20:30:00,134984,17543,20285,14605,6640,16287,210344
2020-09-23,21:00:00,136260,17529,19463,14218,6191,14246,207907
2020-09-23,21:30:00,129156,16606,17920,11825,5495,11716,192718
2020-09-23,22:00:00,126501,15554,16821,11113,5300,11685,186974
2020-09-23,22:30:00,126718,16260,17641,11178,5377,11255,188429
2020-09-23,23:00:00,130629,15978,16532,11374,5154,11828,191495
2020-09-23,23:30:00,127263,15407,16491,11363,5411,11747,187682
2020-09-24,00:00:00,122323,14145,14754,10147,4431,10943,176743
2020-09-24,00:30:00,120727,13737,15227,9414,4244,10238,173587
2020-09-24,01:00:00,116967,12554,13203,7121,4920,8862,163627
2020-09-24,01:30:00,109197,12656,12695,7891,3908,10318,156665
2020-09-24,02:00:00,105437,15427,15078,6291,3911,4991,151135
2020-09-24,02:30:00,100565,14650,14455,6076,3188,2689,141623
2020-09-24,03:00:00,95462,14311,14370,6042,3170,678,134033
2020-09-24,03:30:00,91521,14275,14285,5705,3213,591,129590
2020-09-24,04:00:00,88579,13200,13612,6095,3161,568,125215
2020-09-24,04:30:00,87076,13438,13001,5848,2540,388,122291
2020-09-24,05:00:00,88576,13642,12232,5859,1556,450,122315
2020-09-24,05:30:00,90014,13330,12136,7024,2000,714,125218
2020-09-24,06:00:00,92434,11349,9371,8051,1798,1299,124302
2020-09-24,06:30:00,106032,11776,12090,9072,2280,6321,147571
2020-09-24,07:00:00,111617,11371,12258,8726,2571,7351,153894
2020-09-24,07:30:00,115853,12867,13691,9725,3599,8962,164697
2020-09-24,08:00:00,126384,12744,14722,11309,3593,11182,179934
2020-09-24,08:30:00,135664,15540,18930,14957,4588,15851,205530
2020-09-24,09:00:00,142686,17063,19667,16031,5227,16716,217390
2020-09-24,09:30:00,143319,17733,22089,16825,5638,18186,223790
2020-09-24,10:00:00,134618,16729,18684,13201,5137,14322,202691
2020-09-24,10:30:00,136986,16718,18778,13659,4488,14642,205271
2020-09-24,11:00:00,131405,16453,19121,13707,5146,15002,200834
2020-09-24,11:30:00,134274,16937,19061,13824,5672,15526,205294
2020-09-24,12:00:00,130599,16367,18565,12591,5985,14418,198525
2020-09-24,12:30:00,132120,17293,18448,13776,5606,15339,202582
2020-09-24,13:00:00,132716,17008,20361,14786,5162,16545,206578
2020-09-24,13:30:00,136365,16836,20145,15055,5778,16000,210179
2020-09-24,14:00:00,137913,16123,20716,16467,5237,17411,213867
2020-09-24,14:30:00,127913,16935,19833,13787,6088,16255,200811
2020-09-24,15:00:00,134817,15891,18619,12956,5105,14891,202279
2020-09-24,15:30:00,127605,15638,18740,13415,5106,15048,195552
2020-09-24,16:00:00,128408,16979,19478,14235,5689,15871,200660
2020-09-24,16:30:00,129545,14740,17686,13840,5337,16085,197233
2020-09-24,17:00:00,133208,16398,19812,14204,5640,16196,205458
2020-09-24,17:30:00,130433,15695,21023,15606,5657,16721,205135
2020-09-24,18:00:00,137830,18079,21500,16735,5383,17037,216564
2020-09-24,18:30:00,139075,18885,22381,18093,6004,18784,223222
2020-09-24,19:00:00,139585,17466,21847,17857,6266,18591,221612
2020-09-24,19:30:00,140233,17101,21004,17485,5753,18063,219639
2020-09-24,20:00:00,136099,16488,20236,16300,5825,16333,211281
2020-09-24,20:30:00,136290,16999,19072,14612,5346,14378,206697
2020-09-24,21:00:00,132623,16482,19304,13865,5749,13613,201636
2020-09-24,21:30:00,130957,16146,18449,12112,5684,11880,195228
2020-09-24,22:00:00,127024,15636,17234,11025,5684,11940,188543
2020-09-24,22:30:00,126608,15765,16443,10606,4993,11759,186174
2020-09-24,23:00:00,128950,15491,15466,11248,4905,11713,187773
2020-09-24,23:30:00,125682,16030,16442,11484,5283,11418,186339
2020-09-25,00:00:00,126889,15329,17293,11339,5230,11852,187932
2020-09-25,00:30:00,127125,15329,16943,10268,4353,10801,184819
2020-09-25,01:00:00,115708,12807,14484,7036,4846,7865,162746
2020-09-25,01:30:00,109267,14657,14441,6180,4950,4623,154118
2020-09-25,02:00:00,103804,15706,14285,6388,3829,4421,148433
2020-09-25,02:30:00,100114,14750,13841,6307,3746,4604,143362
2020-09-25,03:00:00,95979,15030,14139,6226,3523,4533,139430
2020-09-25,03:30:00,95234,14252,13549,5945,2679,4710,136369
2020-09-25,04:00:00,92027,14716,12762,5554,2276,1557,128892
2020-09-25,04:30:00,88680,14677,11791,4915,1821,4004,125888
2020-09-25,05:00:00,83950,15198,8219,502,1619,1078,110566
2020-09-25,05:30:00,85727,16035,8884,437,1453,1002,113538
2020-09-25,06:00:00,89178,16501,9116,748,1695,1259,118497
2020-09-25,06:30:00,103883,13622,12414,7631,1812,7633,146995
2020-09-25,07:00:00,108667,11735,12086,7823,2042,8058,150411
2020-09-25,07:30:00,115029,12497,14058,9938,2863,9994,164379
2020-09-25,08:00:00,127841,12856,14703,11051,3850,11250,181551
2020-09-25,08:30:00,138750,14809,18051,13036,4217,14469,203332
2020-09-25,09:00:00,142855,16687,18512,13606,5100,15905,212665
2020-09-25,09:30:00,140061,18302,20163,14562,5338,17382,215808
2020-09-25,10:00:00,136098,16263,18029,12989,4811,14991,203181
2020-09-25,10:30:00,132122,16493,18008,12805,5323,14611,199362
2020-09-25,11:00:00,136266,17403,19259,13536,5412,15943,207819
2020-09-25,11:30:00,132688,17189,17933,12131,5153,14433,199527
2020-09-25,12:00:00,135490,16206,18645,13310,4746,15816,204213
2020-09-25,12:30:00,131895,17575,19753,13713,5184,15302,203422
2020-09-25,13:00:00,134884,18718,20616,13468,5898,14491,208075
2020-09-25,13:30:00,135212,17736,20028,14023,5133,15640,207772
2020-09-25,14:00:00,132605,16679,20534,14402,4977,15504,204701
2020-09-25,14:30:00,124826,16095,17627,12223,5432,13625,189828
2020-09-25,15:00:00,128600,15822,18895,13258,5351,15625,197551
2020-09-25,15:30:00,122793,15674,17885,12131,4655,13850,186988
2020-09-25,16:00:00,128156,16552,19831,13550,6064,15356,199509
2020-09-25,16:30:00,122715,16399,19427,13004,5722,15197,192464
2020-09-25,17:00:00,126714,16086,21682,16274,5359,18259,204374
2020-09-25,17:30:00,129576,17166,21105,15322,5761,17906,206836
2020-09-25,18:00:00,129818,16650,20501,16120,5335,17391,205815
2020-09-25,18:30:00,129542,17180,21550,17347,5621,17398,208638
2020-09-25,19:00:00,135994,17397,22081,18238,6225,19282,219217
2020-09-25,19:30:00,130620,17925,21954,16658,5981,16666,209804
2020-09-25,20:00:00,135636,17860,20845,15907,6297,16548,213093
2020-09-25,20:30:00,131663,18498,21045,15238,6506,15645,208595
2020-09-25,21:00:00,131069,17911,20264,14182,6175,14188,203789
2020-09-25,21:30:00,124564,16403,19813,13452,5560,13556,193348
2020-09-25,22:00:00,122968,16055,18209,12025,5407,12419,187083
2020-09-25,22:30:00,120047,15061,17472,11241,5006,11461,180288
2020-09-25,23:00:00,121907,15134,17723,11705,5308,11674,183451
2020-09-25,23:30:00,120430,14402,17345,11484,5691,12751,182103
2020-09-26,00:00:00,117009,14238,16129,11530,4306,11790,175002
2020-09-26,00:30:00,118729,14176,14769,9654,4327,11066,172721
2020-09-26,01:00:00,110613,13464,13867,7078,2597,9358,156977
2020-09-26,01:30:00,109335,12547,13703,7178,1205,8391,152359
2020-09-26,02:00:00,104305,14627,14884,7367,5480,7986,154649
2020-09-26,02:30:00,99662,15605,15736,7466,2288,1087,141844
2020-09-26,03:00:00,95296,14961,14885,7415,2244,1076,135877
2020-09-26,03:30:00,90572,13697,11842,5449,1327,1288,124175
2020-09-26,04:00:00,90420,14642,7724,266,1477,880,115409
2020-09-26,04:30:00,89099,13675,7380,258,1725,870,113007
2020-09-26,05:00:00,85207,13216,7032,439,1139,931,107964
2020-09-26,05:30:00,84928,14018,7359,279,1553,1039,109176
2020-09-26,06:00:00,85093,13934,7213,293,1285,778,108596
2020-09-26,06:30:00,94614,11641,10062,6980,1533,6494,131324
2020-09-26,07:00:00,95071,9525,9383,7623,1318,6865,129785
2020-09-26,07:30:00,95299,8715,9751,7800,1432,6946,129943
2020-09-26,08:00:00,101917,8767,10262,8223,1895,7542,138606
2020-09-26,08:30:00,104558,9330,10599,9001,1485,8642,143615
2020-09-26,09:00:00,111380,11634,12730,9960,2955,10984,159643
2020-09-26,09:30:00,115027,12826,14566,11800,3240,11889,169348
2020-09-26,10:00:00,122092,14125,17068,13315,4240,13075,183915
2020-09-26,10:30:00,125083,14641,17506,14260,3776,14240,189506
2020-09-26,11:00:00,126452,14805,18979,13344,3915,15189,192684
2020-09-26,11:30:00,124729,16490,18268,13446,4825,16858,194616
2020-09-26,12:00:00,127262,15914,18131,13278,4496,16655,195736
2020-09-26,12:30:00,131270,16417,20330,16238,5009,16126,205390
2020-09-26,13:00:00,133206,17742,20667,16584,4509,15432,208140
2020-09-26,13:30:00,130264,17841,21885,16325,5394,18145,209854
2020-09-26,14:00:00,126887,16499,20487,16767,5018,17263,202921
2020-09-26,14:30:00,126285,15382,20395,13663,4705,17262,197692
2020-09-26,15:00:00,127429,16098,21456,13567,5289,17075,200914
2020-09-26,15:30:00,126936,15793,18400,13589,5612,17001,197331
2020-09-26,16:00:00,128408,15583,21601,13834,5381,17493,202300
2020-09-26,16:30:00,124251,15291,20489,14245,5186,18881,198343
2020-09-26,17:00:00,126583,16086,21615,18416,5359,16878,204937
2020-09-26,17:30:00,129785,16054,22233,16029,5067,17265,206433
2020-09-26,18:00:00,133195,16801,23596,16773,5902,17456,213723
2020-09-26,18:30:00,134410,16469,22439,19461,5772,20324,218875
2020-09-26,19:00:00,137156,16190,23400,20420,5248,19772,222186
2020-09-26,19:30:00,137195,16441,22431,18586,6048,17141,217842
2020-09-26,20:00:00,134911,16473,21797,17608,5784,18433,215006
2020-09-26,20:30:00,132610,16011,19959,15807,6005,15955,206347
2020-09-26,21:00:00,127933,15449,19198,14394,5748,13592,196314
2020-09-26,21:30:00,124180,15065,18735,13623,5560,13092,190255
2020-09-26,22:00:00,122038,14886,16856,12566,4874,12689,183909
2020-09-26,22:30:00,118397,14458,17575,13395,5064,11617,180506
2020-09-26,23:00:00,117628,15051,16344,11165,4977,11928,177093
2020-09-26,23:30:00,117753,15175,16062,11443,5077,11837,177347
2020-09-27,00:00:00,115057,14376,14790,10283,4293,10559,169358
2020-09-27,00:30:00,113979,14315,14894,9562,4661,10526,167937
2020-09-27,01:00:00,112311,13651,14527,10399,3828,8093,162809
2020-09-27,01:30:00,111607,14003,15108,8985,4520,9267,163490
2020-09-27,02:00:00,102845,13594,14568,7528,4476,5082,148093
2020-09-27,02:30:00,100991,15570,15150,7477,3773,5462,148423
2020-09-27,03:00:00,96566,14457,14133,6893,3102,4641,139792
2020-09-27,03:30:00,94277,13809,12970,6776,2815,3916,134563
2020-09-27,04:00:00,92910,14095,13924,7437,2874,2350,133590
2020-09-27,04:30:00,88885,14034,12899,7255,1823,911,125807
2020-09-27,05:00:00,87683,14356,12579,7438,1954,580,124590
2020-09-27,05:30:00,85412,11186,8691,7475,2062,701,115527
2020-09-27,06:00:00,86686,11053,8584,7402,2326,704,116755
2020-09-27,06:30:00,94007,11058,10882,8190,2387,5603,132127
2020-09-27,07:00:00,93075,9643,10253,7423,2019,6423,128836
2020-09-27,07:30:00,93689,9146,10344,7774,1723,6840,129516
2020-09-27,08:00:00,92740,9102,9605,7173,1512,6781,126913
2020-09-27,08:30:00,98055,8868,10313,8134,2033,7743,135146
2020-09-27,09:00:00,102104,9996,11510,8717,2564,7503,142394
2020-09-27,09:30:00,105816,11297,13014,10711,3149,8392,152379
2020-09-27,10:00:00,114917,12675,13275,10741,4956,13449,170013
2020-09-27,10:30:00,117077,12924,16973,11316,3490,13509,175289
2020-09-27,11:00:00,123263,13836,15715,11877,3649,14233,182573
2020-09-27,11:30:00,126147,14095,17035,13196,4404,12631,187508
2020-09-27,12:00:00,125773,14667,17409,13421,4265,11690,187225
2020-09-27,12:30:00,130555,14851,17683,14321,4601,15215,197226
2020-09-27,13:00:00,131614,16027,17827,13793,4346,11842,195449
2020-09-27,13:30:00,130503,16166,18461,13715,5263,12088,196196
2020-09-27,14:00:00,127298,15905,18999,14476,6034,12639,195351
2020-09-27,14:30:00,125419,14382,17117,13550,5378,11967,187813
2020-09-27,15:00:00,125647,13956,16746,13090,5129,12461,187029
2020-09-27,15:30:00,125971,15646,16769,12242,5136,14651,190415
2020-09-27,16:00:00,128134,14665,17723,13025,5244,12875,191666
2020-09-27,16:30:00,129591,15941,18073,13261,6064,12283,195213
2020-09-27,17:00:00,133950,16037,18241,13803,5453,16878,204362
2020-09-27,17:30:00,131271,16125,17983,16029,5413,17265,204086
2020-09-27,18:00:00,133486,15641,21256,16773,5847,17456,210459
2020-09-27,18:30:00,133491,16336,21317,16974,5188,17762,211068
2020-09-27,19:00:00,129850,16217,20592,16758,5501,17507,206425
2020-09-27,19:30:00,133876,15801,21734,17414,5553,17530,211908
2020-09-27,20:00:00,134768,16406,20626,16240,5955,16572,210567
2020-09-27,20:30:00,137528,15965,19540,14897,5794,15086,208810
2020-09-27,21:00:00,135409,15454,17136,12590,5850,13774,200213
2020-09-27,21:30:00,134349,15353,16941,12045,5692,10674,195054
2020-09-27,22:00:00,135256,16825,17561,11522,5696,10884,197744
2020-09-27,22:30:00,134047,15765,16071,12118,4468,11308,193777
2020-09-27,23:00:00,127262,14065,15640,11780,4153,11674,184574
2020-09-27,23:30:00,126410,13900,15624,11574,3645,10468,181621
2020-09-28,00:00:00,125366,13850,15753,10972,4222,9736,179899
2020-09-28,00:30:00,128221,13643,16709,10672,5272,10006,184523
2020-09-28,01:00:00,117401,11663,14126,8284,3061,8457,162992
2020-09-28,01:30:00,113866,11066,12857,6998,1988,7944,154719
2020-09-28,02:00:00,108655,14037,14321,7541,3005,3333,150892
2020-09-28,02:30:00,103774,14039,14434,7319,2529,963,143058
2020-09-28,03:00:00,91387,8462,14291,6805,2061,782,123788
2020-09-28,03:30:00,86628,8920,15050,7270,2523,821,121212
2020-09-28,04:00:00,99548,8845,14563,6853,2260,861,132930
2020-09-28,04:30:00,80053,9260,15061,7833,2016,1877,116100
2020-09-28,05:00:00,79318,12300,9462,6937,2033,1158,111208
2020-09-28,05:30:00,93214,5851,2470,318,1953,1529,105335
2020-09-28,06:00:00,89372,5827,2522,455,2009,1185,101370
2020-09-28,06:30:00,103024,10313,11790,8055,2193,6719,142094
2020-09-28,07:00:00,105225,10369,12616,9129,3076,8065,148480
2020-09-28,07:30:00,112779,12537,13976,10956,4336,10142,164726
2020-09-28,08:00:00,119387,12733,15098,11682,4231,12086,175217
2020-09-28,08:30:00,132424,13556,14896,11618,4025,13219,189738
2020-09-28,09:00:00,138363,16983,17799,13402,6307,15168,208022
2020-09-28,09:30:00,137149,16819,18524,14295,5799,15834,208420
2020-09-28,10:00:00,130724,15487,16569,12200,5248,14535,194763
2020-09-28,10:30:00,132614,15632,16652,11398,5263,13932,195491
2020-09-28,11:00:00,132984,15451,16348,11788,4828,13001,194400
2020-09-28,11:30:00,132254,14802,16037,11645,4980,13178,192896
2020-09-28,12:00:00,130890,15114,18131,11419,5463,12547,193564
2020-09-28,12:30:00,134887,15837,16199,12110,4735,14002,197770
2020-09-28,13:00:00,133242,15514,17529,13288,5966,14859,200398
2020-09-28,13:30:00,132416,15777,16473,11821,5263,14784,196534
2020-09-28,14:00:00,127549,16094,19838,11805,5334,13229,193849
2020-09-28,14:30:00,121607,13394,15173,10898,5244,11205,177521
2020-09-28,15:00:00,122762,15003,16182,13567,5150,12617,185281
2020-09-28,15:30:00,128655,16255,17552,12265,6195,14484,195406
2020-09-28,16:00:00,127800,14420,17034,12120,5696,14366,191436
2020-09-28,16:30:00,125418,14092,17118,12837,5869,14340,189674
2020-09-28,17:00:00,131618,15646,19159,14880,5387,16892,203582
2020-09-28,17:30:00,134314,16745,20892,15927,6123,18000,212001
2020-09-28,18:00:00,137011,17845,22625,16974,6860,19108,220423
2020-09-28,18:30:00,140956,19052,23390,17777,6599,19804,227578
2020-09-28,19:00:00,138512,18767,21919,17376,6248,19125,221947
2020-09-28,19:30:00,138718,18578,22411,17154,5899,18066,220826
2020-09-28,20:00:00,135636,18422,20859,16002,6410,17138,214467
2020-09-28,20:30:00,135242,17189,19963,15202,5779,14924,208299
2020-09-28,21:00:00,135090,15804,18010,13331,5651,14998,202884
2020-09-28,21:30:00,127647,14876,16331,11842,5399,13541,189636
2020-09-28,22:00:00,127760,13687,17195,11711,4649,12664,187666
2020-09-28,22:30:00,129298,14179,15217,10652,4397,11569,185312
2020-09-28,23:00:00,129385,13973,14864,10967,3734,11609,184532
2020-09-28,23:30:00,131717,14405,14705,11504,3997,13443,189771
2020-09-29,00:00:00,126642,13226,13263,9965,4661,11456,179213
2020-09-29,00:30:00,124372,13017,15048,9907,4009,11418,177771
2020-09-29,01:00:00,115896,12247,16076,8760,2774,10428,166181
2020-09-29,01:30:00,112696,12296,17062,9460,3740,8591,163845
2020-09-29,02:00:00,100157,13167,17267,9651,2436,7227,149905
2020-09-29,02:30:00,96072,13357,15781,9976,2002,3575,140763
2020-09-29,03:00:00,91990,13760,15920,10677,2461,3650,138458
2020-09-29,03:30:00,91581,10912,12106,10549,2346,3069,130563
2020-09-29,04:00:00,90128,9869,11943,10384,1947,3150,127421
2020-09-29,04:30:00,93152,11065,12029,10252,2152,1225,129875
2020-09-29,05:00:00,95625,11973,9285,7934,2242,701,127760
2020-09-29,05:30:00,94476,11936,9283,7929,1969,874,126467
2020-09-29,06:00:00,94333,12327,9105,7640,2403,928,126736
2020-09-29,06:30:00,106452,12209,12176,9034,2882,6408,149161
2020-09-29,07:00:00,111563,11337,13244,9173,2944,7630,155891
2020-09-29,07:30:00,117209,11826,14446,10677,3743,8959,166860
2020-09-29,08:00:00,126522,12596,14465,11980,3830,10454,179847
2020-09-29,08:30:00,135627,14788,17670,14446,4592,14515,201638
2020-09-29,09:00:00,142595,17516,20062,16555,5648,17365,219741
2020-09-29,09:30:00,143473,18271,21097,15867,5536,17592,221836
2020-09-29,10:00:00,137950,16728,20702,14989,5713,15710,211792
2020-09-29,10:30:00,133008,16618,17514,13242,5451,13791,199624
2020-09-29,11:00:00,131803,15769,16368,11673,4037,12719,192369
2020-09-29,11:30:00,131554,16162,17676,13233,4288,14021,196934
2020-09-29,12:00:00,130070,15961,16799,12254,5181,14479,194744
2020-09-29,12:30:00,133032,17327,19251,14213,5081,15580,204484
2020-09-29,13:00:00,131872,16783,19397,14695,5869,16799,205415
2020-09-29,13:30:00,136545,17876,20577,15643,5980,16626,213247
2020-09-29,14:00:00,134587,17266,20160,14972,5630,15979,208594
2020-09-29,14:30:00,133367,17239,19792,14976,5954,15253,206581
2020-09-29,15:00:00,127513,15801,18888,13833,5331,14467,195833
2020-09-29,15:30:00,130893,15562,18278,13397,6036,15453,199619
2020-09-29,16:00:00,129852,14640,17631,12878,5318,15593,195912
2020-09-29,16:30:00,133213,16185,19033,14077,5867,15601,203976
2020-09-29,17:00:00,133834,16102,19634,14871,6014,16038,206493
2020-09-29,17:30:00,134456,16020,20235,15665,6162,16476,209014
2020-09-29,18:00:00,134739,15187,20385,15310,5791,16826,208238
2020-09-29,18:30:00,138151,18080,22314,17364,7087,19299,222295
2020-09-29,19:00:00,140395,17241,22167,18057,6277,19750,223887
2020-09-29,19:30:00,136754,16028,20344,16489,5862,18446,213923
2020-09-29,20:00:00,143859,17467,23109,18169,6831,18283,227718
2020-09-29,20:30:00,136909,16523,21380,15020,6447,16000,212279
2020-09-29,21:00:00,136865,15877,18531,13951,5880,14480,205584
2020-09-29,21:30:00,130567,16162,18145,13033,6467,13752,198126
2020-09-29,22:00:00,129728,15892,16241,11345,5745,12427,191378
2020-09-29,22:30:00,133272,14712,16249,11689,5214,12604,193740
2020-09-29,23:00:00,134096,15181,16006,11397,4901,12352,193933
2020-09-29,23:30:00,129407,16574,16382,11205,5510,12399,191477
2020-09-30,00:00:00,124710,14377,15101,10279,4953,10587,180007
2020-09-30,00:30:00,127249,13876,15279,8907,5419,10076,180806
2020-09-30,01:00:00,116443,11387,15285,7101,3216,8439,161871
2020-09-30,01:30:00,114206,11737,15220,8270,3396,7726,160555
2020-09-30,02:00:00,109328,15020,16743,8324,3722,2502,155639
2020-09-30,02:30:00,102964,15523,15502,8177,2861,2170,147197
2020-09-30,03:00:00,97224,13860,12962,6253,2232,3177,135708
2020-09-30,03:30:00,95975,13846,12766,5966,2103,547,131203
2020-09-30,04:00:00,92733,13442,13657,7266,2040,486,129624
2020-09-30,04:30:00,90967,12455,11163,7051,1883,656,124175
2020-09-30,05:00:00,91897,10071,9496,7875,2315,838,122492
2020-09-30,05:30:00,92253,10226,9810,7857,2036,569,122751
2020-09-30,06:00:00,96684,10346,10084,8232,2640,1183,129169
2020-09-30,06:30:00,111352,10999,11880,9089,2159,5886,151365
2020-09-30,07:00:00,111031,10987,12433,8998,2297,8429,154175
2020-09-30,07:30:00,116557,11274,13105,10275,2599,10102,163912
2020-09-30,08:00:00,128134,13323,14944,11673,3192,11340,182606
2020-09-30,08:30:00,134472,15062,16829,12802,4067,14658,197890
2020-09-30,09:00:00,141602,16138,18370,13931,4920,15176,210137
2020-09-30,09:30:00,135198,17631,18852,14423,4677,15316,206097
2020-09-30,10:00:00,138204,17670,19164,15625,6009,15602,212274
2020-09-30,10:30:00,133512,15746,17049,13587,5261,14903,200058
2020-09-30,11:00:00,134050,15932,18212,13118,4916,13863,200091
2020-09-30,11:30:00,137179,16707,18438,13922,5561,14009,205816
2020-09-30,12:00:00,134660,16471,19192,13982,5583,13754,203642
2020-09-30,12:30:00,132556,15479,17651,13815,5183,14008,198692
2020-09-30,13:00:00,137934,17148,20328,16130,5971,17168,214679
2020-09-30,13:30:00,139042,18768,21019,16638,5904,16810,218181
2020-09-30,14:00:00,139806,17446,22182,16393,6313,17608,219748
2020-09-30,14:30:00,136015,18397,21228,15576,6169,15721,213106
2020-09-30,15:00:00,135313,16964,20381,14804,5504,14720,207686
2020-09-30,15:30:00,131985,16423,19407,14139,4586,14154,200694
2020-09-30,16:00:00,137018,17225,20982,16139,5535,16532,213431
2020-09-30,16:30:00,133571,17499,20465,14973,5794,16361,208663
2020-09-30,17:00:00,135395,17954,21000,15516,5451,16684,212000
2020-09-30,17:30:00,128976,16571,19845,14492,4513,16102,200499
2020-09-30,18:00:00,134741,16468,21834,18013,6086,20026,217168
2020-09-30,18:30:00,134326,17007,22902,17569,5780,19136,216720
2020-09-30,19:00:00,141959,18994,24678,19126,6229,19753,230739
2020-09-30,19:30:00,142139,18659,23476,19329,6467,19471,229541
2020-09-30,20:00:00,143321,17719,23288,19233,6129,19030,228720
2020-09-30,20:30:00,136766,15784,20633,15909,5820,16995,211907
2020-09-30,21:00:00,135506,16255,19442,15214,5140,15184,206741
2020-09-30,21:30:00,132077,15582,18295,14137,4173,12177,196441
2020-09-30,22:00:00,131381,16498,17878,12295,5240,11022,194314
2020-09-30,22:30:00,129550,15173,18033,12684,4923,11664,192027
2020-09-30,23:00:00,131518,16390,18211,13810,4933,12472,197334
2020-09-30,23:30:00,128426,16176,18117,13429,5930,13094,195172
2020-10-01,00:00:00,126886,14252,16318,11237,5375,11353,185421
2020-10-01,00:30:00,127219,14910,16870,10593,5522,10377,185491
2020-10-01,01:00:00,116057,14409,15218,8970,5195,9930,169779
2020-10-01,01:30:00,112265,12982,13858,8002,3758,8581,159446
2020-10-01,02:00:00,107541,12019,13285,7850,2851,7921,151467
2020-10-01,02:30:00,97341,13150,15638,9493,2130,6660,144412
2020-10-01,03:00:00,90876,12949,15016,9253,1822,2719,132635
2020-10-01,03:30:00,88754,14164,15526,9067,1974,2187,131672
2020-10-01,04:00:00,87075,14967,15723,9419,2115,2382,131681
2020-10-01,04:30:00,84754,15062,14843,8605,2015,2113,127392
2020-10-01,05:00:00,84728,14664,14206,7781,1926,838,124143
2020-10-01,05:30:00,84487,14078,13760,8453,1862,859,123499
2020-10-01,06:00:00,88121,11717,10973,7849,2403,1265,122328
2020-10-01,06:30:00,105849,11483,13408,8893,2644,7056,149333
2020-10-01,07:00:00,109183,10828,12158,9270,2268,8031,151738
2020-10-01,07:30:00,116614,12563,13797,10688,2890,9538,166090
2020-10-01,08:00:00,123758,12304,14858,12780,3763,12758,180221
2020-10-01,08:30:00,133455,14623,16899,14250,4346,14889,198462
2020-10-01,09:00:00,142262,16858,19939,16572,5436,17711,218778
2020-10-01,09:30:00,141922,18340,20870,15634,5438,17472,219676
2020-10-01,10:00:00,137225,15988,17837,13561,4584,15798,204993
2020-10-01,10:30:00,132728,14868,18370,13069,4260,13986,197281
2020-10-01,11:00:00,131757,15667,17440,11999,5140,12903,194906
2020-10-01,11:30:00,130073,15534,17324,12094,4924,13201,193150
2020-10-01,12:00:00,125445,14823,16391,11827,4219,12915,185620
2020-10-01,12:30:00,127159,15557,18899,13774,4658,15364,195411
2020-10-01,13:00:00,135236,16710,19196,14929,5493,15672,207236
2020-10-01,13:30:00,137166,18065,22304,16796,5816,16110,216257
2020-10-01,14:00:00,135492,17639,21162,15640,5294,16063,211290
2020-10-01,14:30:00,138078,16825,20361,15769,5124,15720,211877
2020-10-01,15:00:00,122690,16493,16457,11304,4069,11596,182609
2020-10-01,15:30:00,131113,16603,20321,14927,4829,15255,203048
2020-10-01,16:00:00,130922,15689,20906,15845,5470,16228,205060
2020-10-01,16:30:00,134150,15860,21243,16063,5098,15730,208144
2020-10-01,17:00:00,130608,16129,18972,13735,5389,14279,199112
2020-10-01,17:30:00,130820,15934,19949,16084,5151,16036,203974
2020-10-01,18:00:00,131741,17530,21593,17317,6168,18660,213009
2020-10-01,18:30:00,133886,16451,21771,18482,6797,19403,216790
2020-10-01,19:00:00,132881,15782,20968,17070,6266,18278,211245
2020-10-01,19:30:00,137601,17938,21917,17828,6394,18697,220375
2020-10-01,20:00:00,140383,17363,21775,18852,6514,19343,224230
2020-10-01,20:30:00,138202,16274,19451,15797,5692,16089,211505
2020-10-01,21:00:00,134596,16653,18631,13846,5900,13220,202846
2020-10-01,21:30:00,132284,17279,19373,14725,6443,15059,205163
2020-10-01,22:00:00,129333,16209,17529,12549,5406,12565,193591
2020-10-01,22:30:00,129068,14816,17232,12459,5093,11979,190647
2020-10-01,23:00:00,132124,15358,18371,12992,5179,12169,196193
2020-10-01,23:30:00,128763,14654,17150,12418,4986,11730,189701
2020-10-02,00:00:00,125402,13950,15930,11845,4794,11292,183213
2020-10-02,00:30:00,122808,15219,16188,10044,6074,10658,180991
2020-10-02,01:00:00,117318,14992,16358,9068,6874,9570,174180
2020-10-02,01:30:00,113198,12750,14865,7038,3920,5812,157583
2020-10-02,02:00:00,104501,14619,16141,7362,4114,5448,152185
2020-10-02,02:30:00,97084,15080,15949,7192,3769,4608,143682
2020-10-02,03:00:00,94580,14166,14744,7092,2758,4007,137347
2020-10-02,03:30:00,90162,9542,15150,6571,2241,798,124464
2020-10-02,04:00:00,89009,9122,14848,6406,1985,674,122044
2020-10-02,04:30:00,83856,9078,15012,6726,1848,788,117308
2020-10-02,05:00:00,81448,8664,14358,7781,1629,676,114556
2020-10-02,05:30:00,83375,8502,14350,6737,2036,653,115653
2020-10-02,06:00:00,87106,9161,14958,6876,2315,1186,121602
2020-10-02,06:30:00,103457,11725,13984,8983,2356,6440,146945
2020-10-02,07:00:00,108142,10766,12925,9429,2685,7899,151846
2020-10-02,07:30:00,112648,11926,13198,9925,3268,9457,160422
2020-10-02,08:00:00,124227,12464,14811,11629,3084,12167,178382
2020-10-02,08:30:00,130179,13292,15192,12847,3423,14834,189767
2020-10-02,09:00:00,130610,15435,16323,12836,4693,14669,194566
2020-10-02,09:30:00,134564,17042,20304,15574,5621,16346,209451
2020-10-02,10:00:00,135535,16788,17392,13515,5019,14508,202757
2020-10-02,10:30:00,130571,16023,17654,13217,5048,13719,196232
2020-10-02,11:00:00,126435,15744,17382,13066,4555,15219,192401
2020-10-02,11:30:00,125028,14391,16562,12694,4238,15009,187922
2020-10-02,12:00:00,128562,15183,17012,13954,4317,15022,194050
2020-10-02,12:30:00,129149,16629,18557,14293,5058,16034,199720
2020-10-02,13:00:00,132465,16795,20253,15856,5697,16939,208005
2020-10-02,13:30:00,132960,16745,19895,15922,5328,17293,208143
2020-10-02,14:00:00,129255,17031,18915,14022,6082,15295,200600
2020-10-02,14:30:00,127288,16310,18827,13470,5506,14423,195824
2020-10-02,15:00:00,126624,16999,19546,14469,5537,15266,198441
2020-10-02,15:30:00,128676,17682,19870,14635,5917,15347,202127
2020-10-02,16:00:00,127742,15873,19130,14862,5832,15511,198950
2020-10-02,16:30:00,129919,16398,19977,15472,6079,16419,204264
2020-10-02,17:00:00,129152,17096,21923,17377,6374,17914,209836
2020-10-02,17:30:00,134798,17169,21524,17738,5399,18542,215170
2020-10-02,18:00:00,137549,18845,23681,19415,6199,20425,226114
2020-10-02,18:30:00,139460,18805,23959,19042,6304,19985,227555
2020-10-02,19:00:00,139662,18980,22744,18558,6469,19786,226199
2020-10-02,19:30:00,136903,17613,22334,18769,5597,18214,219430
2020-10-02,20:00:00,132847,17130,21916,18412,5396,17532,213233
2020-10-02,20:30:00,130739,16829,20239,15532,5175,15353,203867
2020-10-02,21:00:00,131516,15422,18743,14257,5625,13570,199133
2020-10-02,21:30:00,127614,15394,17725,13022,5225,13010,191990
2020-10-02,22:00:00,127102,15282,17057,11858,5406,12153,188858
2020-10-02,22:30:00,124305,14676,16913,11842,5021,13079,185836
2020-10-02,23:00:00,126112,14294,17956,13536,4922,13182,190002
2020-10-02,23:30:00,128474,13746,17195,13694,4910,13871,191890
2020-10-03,00:00:00,124205,13658,16375,12485,4219,12008,182950
2020-10-03,00:30:00,121797,12927,15499,11308,4464,11170,177165
2020-10-03,01:00:00,119271,12932,15696,9347,2973,10047,170266
2020-10-03,01:30:00,116770,13147,15424,8250,3283,8718,165592
2020-10-03,02:00:00,112546,12800,16294,8697,3745,8750,162832
2020-10-03,02:30:00,107687,13731,16461,8105,3472,7760,157216
2020-10-03,03:00:00,101739,13393,17906,7694,2718,4892,148342
2020-10-03,03:30:00,94399,10183,17544,7253,2436,3947,135762
2020-10-03,04:00:00,94084,10598,17665,8185,2270,3082,135884
2020-10-03,04:30:00,89319,9896,16555,8234,2209,701,126914
2020-10-03,05:00:00,85516,9360,15984,8089,2283,698,121930
2020-10-03,05:30:00,80495,8802,15226,7619,1981,545,114668
2020-10-03,06:00:00,79695,9086,15379,7315,2405,743,114623
2020-10-03,06:30:00,95311,10027,13561,8304,1928,6545,135676
2020-10-03,07:00:00,98423,9144,11087,7775,1440,6236,134105
2020-10-03,07:30:00,96827,9542,11052,8664,1525,6678,134288
2020-10-03,08:00:00,98596,9095,11353,8964,1800,7542,137350
2020-10-03,08:30:00,103025,9398,11829,9224,2442,8063,143981
2020-10-03,09:00:00,108123,10756,12816,10548,2503,9365,154111
2020-10-03,09:30:00,116537,13157,15311,10928,3798,11017,170748
2020-10-03,10:00:00,120775,14232,18149,13909,3829,12478,183372
2020-10-03,10:30:00,125010,15554,17510,13140,4911,13573,189698
2020-10-03,11:00:00,128839,15961,17832,13208,5513,15590,196943
2020-10-03,11:30:00,129932,17976,18116,13706,5020,15447,200197
2020-10-03,12:00:00,130128,17247,20779,13734,5169,17407,204464
2020-10-03,12:30:00,131737,16856,19277,14611,4829,17401,204711
2020-10-03,13:00:00,129565,17217,21599,17019,5407,17103,207910
2020-10-03,13:30:00,130084,17547,22422,17357,5280,15603,208293
2020-10-03,14:00:00,130818,17745,23464,17270,5289,18674,213260
2020-10-03,14:30:00,131826,17688,22179,17124,6035,16635,211487
2020-10-03,15:00:00,131676,18019,21067,16592,6025,16170,209549
2020-10-03,15:30:00,130426,16552,21230,14330,5596,15253,203387
2020-10-03,16:00:00,129724,17099,21378,16265,6561,16837,207864
2020-10-03,16:30:00,124145,15429,21997,15394,6385,18932,202282
2020-10-03,17:00:00,126561,16705,23411,19623,6215,19623,212138
2020-10-03,17:30:00,125933,17122,22529,18507,6523,18912,209526
2020-10-03,18:00:00,134777,15983,20971,17704,6139,18585,214159
2020-10-03,18:30:00,127471,14926,20312,17708,5750,18315,204482
2020-10-03,19:00:00,129200,15014,19811,17076,6229,17427,204757
2020-10-03,19:30:00,132931,16707,22157,18769,6327,18943,215834
2020-10-03,20:00:00,132197,17171,20608,16426,5398,16525,208325
2020-10-03,20:30:00,129668,15721,19717,15582,5830,15205,201723
2020-10-03,21:00:00,128624,15638,19348,15321,5801,14917,199649
2020-10-03,21:30:00,127072,14934,17607,13016,6402,13733,192764
2020-10-03,22:00:00,124867,15304,17480,12373,5308,11987,187319
2020-10-03,22:30:00,122254,14519,16586,13084,5021,13428,184892
2020-10-03,23:00:00,125485,15435,17168,12210,5296,12553,188147
2020-10-03,23:30:00,128426,14847,17235,12304,5301,12144,190257
2020-10-04,00:00:00,124183,14912,16767,12319,4563,11903,184647
2020-10-04,00:30:00,126412,13999,16964,10821,5207,12004,185407
2020-10-04,01:00:00,119385,14391,15949,8648,5273,11181,174827
2020-10-04,01:30:00,116671,12895,16990,8981,3740,11080,170357
2020-10-04,02:00:00,110803,13702,14630,7732,3470,6110,156447
2020-10-04,02:30:00,107927,13566,14930,8522,2656,6365,153966
2020-10-04,03:00:00,103094,13841,16122,8721,3298,2844,147920
2020-10-04,03:30:00,96885,12702,14279,8112,2499,1002,135479
2020-10-04,04:00:00,95319,15191,15659,8543,2362,871,137945
2020-10-04,04:30:00,91100,15310,15750,8710,2103,771,133744
2020-10-04,05:00:00,90574,14169,15255,7660,2016,702,130376
2020-10-04,05:30:00,89169,8965,14998,7030,1950,763,122875
2020-10-04,06:00:00,87313,8996,15398,7600,2313,792,122412
2020-10-04,06:30:00,99171,10206,12384,8893,1698,6117,138469
2020-10-04,07:00:00,95638,9341,11276,7612,1765,5696,131328
2020-10-04,07:30:00,94582,9454,11561,8346,1542,5809,131294
2020-10-04,08:00:00,96010,8939,10769,10937,2075,6084,134814
2020-10-04,08:30:00,97535,9220,10412,7636,2134,6431,133368
2020-10-04,09:00:00,104817,10634,12520,9766,2821,8111,148669
2020-10-04,09:30:00,108477,10954,12516,9132,4680,8202,153961
2020-10-04,10:00:00,114393,15663,18172,13752,3444,14144,179568
2020-10-04,10:30:00,129679,15427,17510,13140,4842,13708,194306
2020-10-04,11:00:00,123495,15528,16968,12753,4000,11123,183867
2020-10-04,11:30:00,124119,16985,17950,13283,4553,12432,189322
2020-10-04,12:00:00,126806,17230,18355,13657,5368,11898,193314
2020-10-04,12:30:00,129614,17672,19693,14466,5541,15140,202126
2020-10-04,13:00:00,129127,16508,18226,13249,5393,16046,198549
2020-10-04,13:30:00,126941,17431,17321,15578,5390,15552,198213
2020-10-04,14:00:00,127676,17446,16907,14983,5382,15922,198316
2020-10-04,14:30:00,125851,16915,17135,12179,5202,14974,192256
2020-10-04,15:00:00,126356,16379,18341,12518,5843,12473,191910
2020-10-04,15:30:00,126161,15445,18055,12981,5053,15253,192948
2020-10-04,16:00:00,127040,14752,17663,13304,4934,15657,193350
2020-10-04,16:30:00,128894,15879,18294,13523,5587,14102,196279
2020-10-04,17:00:00,130208,16251,18533,12776,6179,13156,197103
2020-10-04,17:30:00,133215,17173,18748,13238,7178,13626,203178
2020-10-04,18:00:00,132166,15915,18892,16998,6467,18282,208720
2020-10-04,18:30:00,133675,14966,21841,17561,5641,18712,212396
2020-10-04,19:00:00,137621,15645,18994,17578,5727,18425,213990
2020-10-04,19:30:00,137384,16163,21575,14544,5778,18111,213555
2020-10-04,20:00:00,136227,17218,18304,17437,6660,17482,213328
2020-10-04,20:30:00,138387,15906,18179,14559,6187,14241,207459
2020-10-04,21:00:00,136002,15721,17978,13221,6203,12925,202050
2020-10-04,21:30:00,135406,15850,18388,12716,6105,12225,200690
2020-10-04,22:00:00,130898,14678,15831,10383,5332,11719,188841
2020-10-04,22:30:00,130333,14716,15845,10957,5094,11633,188578
2020-10-04,23:00:00,132114,14307,15214,10573,5184,12445,189837
2020-10-04,23:30:00,127453,13372,14982,10983,5066,12267,184123
2020-10-05,00:00:00,124111,12980,14567,11051,3689,10348,176746
2020-10-05,00:30:00,122554,12589,13777,10377,2748,11552,173597
2020-10-05,01:00:00,117207,12524,14604,7603,3652,9729,165319
2020-10-05,01:30:00,110834,11127,14135,6864,3977,4909,151846
2020-10-05,02:00:00,105985,12251,14403,6993,3204,4764,147600
2020-10-05,02:30:00,95751,13463,13872,7332,2408,4718,137544
2020-10-05,03:00:00,87911,13505,13995,7344,2148,3648,128551
2020-10-05,03:30:00,82968,13108,14093,7944,2109,625,120847
2020-10-05,04:00:00,81530,11743,14633,7351,2189,732,118178
2020-10-05,04:30:00,77371,8124,14528,7461,2128,619,110231
2020-10-05,05:00:00,77209,8181,14508,7582,2460,707,110647
2020-10-05,05:30:00,75809,8679,14933,7484,1989,566,109460
2020-10-05,06:00:00,75941,8656,14923,7642,2141,1396,110699
2020-10-05,06:30:00,100625,10006,13074,8984,2101,7218,142008
2020-10-05,07:00:00,106193,9543,11978,9760,2312,8394,148180
2020-10-05,07:30:00,115038,11731,14058,11465,2927,10475,165694
2020-10-05,08:00:00,123978,12287,14761,12003,2929,12037,177995
2020-10-05,08:30:00,133969,13303,15905,13507,3545,13889,194118
2020-10-05,09:00:00,137391,15998,18451,14869,5243,16482,208434
2020-10-05,09:30:00,134882,16284,19115,15164,5332,15880,206657
2020-10-05,10:00:00,138931,15932,19158,13928,5440,15440,208829
2020-10-05,10:30:00,135715,15933,17731,12973,5747,15489,203588
2020-10-05,11:00:00,135127,16113,17466,12950,5557,14708,201921
2020-10-05,11:30:00,134150,17167,17786,13839,5850,15443,204235
2020-10-05,12:00:00,134091,17565,17921,13545,5935,14969,204026
2020-10-05,12:30:00,137237,17854,19395,13973,5243,15219,208921
2020-10-05,13:00:00,136376,16940,18663,14587,5546,16230,208342
2020-10-05,13:30:00,135981,17672,19424,14829,5610,15497,209013
2020-10-05,14:00:00,133902,17697,20152,14863,5522,16352,208488
2020-10-05,14:30:00,135762,17263,18185,13667,5033,15546,205456
2020-10-05,15:00:00,132489,17177,18286,13781,4731,14329,200793
2020-10-05,15:30:00,129642,16837,17729,13242,5010,15218,197678
2020-10-05,16:00:00,132195,18851,21421,15242,6496,16062,210267
2020-10-05,16:30:00,132643,18363,20782,15687,6686,17674,211835
2020-10-05,17:00:00,133520,18291,22598,17418,6496,19237,217560
2020-10-05,17:30:00,133863,17108,21368,17147,7193,19516,216195
2020-10-05,18:00:00,134777,17458,22258,17696,6447,19819,218455
2020-10-05,18:30:00,136863,19298,24590,20227,6970,21049,228997
2020-10-05,19:00:00,148462,19335,23271,18647,6399,20013,236127
2020-10-05,19:30:00,138508,19372,21952,17067,5828,18978,221705
2020-10-05,20:00:00,147925,17660,21005,17289,5083,17521,226483
2020-10-05,20:30:00,137187,16678,22221,15747,6168,18027,216028
2020-10-05,21:00:00,135036,16248,20542,16459,5914,15610,209809
2020-10-05,21:30:00,136594,16439,18698,14615,5467,14419,206232
2020-10-05,22:00:00,132904,16200,17460,13495,5244,12943,198246
2020-10-05,22:30:00,132273,16021,15829,12341,5041,11635,193140
2020-10-05,23:00:00,130811,15410,15534,12258,4771,12951,191735
2020-10-05,23:30:00,128302,14808,15701,12020,4847,12165,187843
2020-10-06,00:00:00,129478,15105,15364,12239,5055,13225,190466
2020-10-06,00:30:00,123355,12378,13229,10438,3750,13676,176826
2020-10-06,01:00:00,112143,11795,11327,7856,3166,12384,158671
2020-10-06,01:30:00,111790,14426,11367,7548,3250,11947,160328
2020-10-06,02:00:00,98409,16111,14849,8051,3596,9328,150344
2020-10-06,02:30:00,95909,12962,17963,7641,3492,931,138898
2020-10-06,03:00:00,86772,14283,17021,7400,3046,644,129166
2020-10-06,03:30:00,85253,14354,16223,8544,1961,823,127158
2020-10-06,04:00:00,81461,14157,15146,7487,2120,875,121246
2020-10-06,04:30:00,78959,13950,15022,7739,1659,848,118177
2020-10-06,05:00:00,77947,8872,15608,7873,1716,849,112865
2020-10-06,05:30:00,78453,8437,14644,7419,1592,665,111210
2020-10-06,06:00:00,79488,9272,15688,7995,1979,1035,115457
2020-10-06,06:30:00,97613,11273,14113,8573,2325,6480,140377
2020-10-06,07:00:00,106524,10740,12524,9284,2191,7628,148891
2020-10-06,07:30:00,113138,11347,13938,11367,2327,10357,162474
2020-10-06,08:00:00,121500,12638,15298,12442,3600,11761,177239
2020-10-06,08:30:00,129654,14214,17066,13763,4279,14279,193255
2020-10-06,09:00:00,136977,15933,18808,15341,4903,16871,208833
2020-10-06,09:30:00,144521,18343,21880,18612,6162,19704,229222
2020-10-06,10:00:00,121372,8636,9256,12751,2257,9221,163493
2020-10-06,10:30:00,141648,17056,19935,15355,4847,15010,213851
2020-10-06,11:00:00,136454,16395,20093,15160,4903,16999,210004
2020-10-06,11:30:00,134418,16486,19092,14512,4964,14632,204104
2020-10-06,12:00:00,134118,17202,18752,13864,5037,14811,203784
2020-10-06,12:30:00,134740,16354,18666,14267,4823,15535,204385
2020-10-06,13:00:00,137126,17075,18845,14827,5011,16297,209181
2020-10-06,13:30:00,138688,17294,20369,16185,5635,17227,215398
2020-10-06,14:00:00,137500,16990,20170,15447,5824,15823,211754
2020-10-06,14:30:00,138015,17329,19969,14306,6222,15852,211693
2020-10-06,15:00:00,131478,16910,19012,13928,6144,14835,202307
2020-10-06,15:30:00,131594,17166,19204,13584,5666,15378,202592
2020-10-06,16:00:00,136153,16758,19637,15745,4750,16133,209176
2020-10-06,16:30:00,135389,16741,19470,16075,5315,16540,209530
2020-10-06,17:00:00,135119,16209,19826,16790,4930,17206,210080
2020-10-06,17:30:00,139031,17761,21334,17822,5907,18153,220008
2020-10-06,18:00:00,138276,18469,23244,18453,6918,18810,224170
2020-10-06,18:30:00,142351,20465,25927,21242,6084,23498,239567
2020-10-06,19:00:00,154981,20188,26210,21063,6732,22548,251722
2020-10-06,19:30:00,150203,19726,24663,20115,6627,19365,240699
2020-10-06,20:00:00,143026,17675,21615,16732,6218,16762,222028
2020-10-06,20:30:00,139053,17303,19472,14953,5717,15394,211892
2020-10-06,21:00:00,135887,17631,19323,15315,5543,15313,209012
2020-10-06,21:30:00,130588,16227,17759,13454,6450,12532,197010
2020-10-06,22:00:00,130683,16377,16455,12385,5745,12343,193988
2020-10-06,22:30:00,130142,15269,16194,12828,5306,12093,191832
2020-10-06,23:00:00,129322,15930,16269,12368,4983,12917,191789
2020-10-06,23:30:00,126953,15270,16370,11634,5594,11426,187247
2020-10-07,00:00:00,124037,15056,15237,11787,4309,11262,181688
2020-10-07,00:30:00,125546,14108,14498,10649,3852,11990,180643
2020-10-07,01:00:00,117068,13028,13159,10299,2795,11898,168247
2020-10-07,01:30:00,112978,12027,14902,9144,2979,8220,160250
2020-10-07,02:00:00,107982,15725,17599,10040,3874,6683,161903
2020-10-07,02:30:00,100527,14660,15862,7894,3239,2121,144303
2020-10-07,03:00:00,93410,14858,13312,7576,2313,833,132302
2020-10-07,03:30:00,87752,14405,13314,7794,1685,897,125847
2020-10-07,04:00:00,85853,14404,13399,8373,1558,892,124479
2020-10-07,04:30:00,88446,14178,12724,8479,1456,802,126085
2020-10-07,05:00:00,87706,14962,13478,8325,1755,716,126942
2020-10-07,05:30:00,88064,14276,13048,8014,2044,796,126242
2020-10-07,06:00:00,90288,14953,13527,8625,1837,1156,130386
2020-10-07,06:30:00,103741,11712,12746,9117,1917,6626,145859
2020-10-07,07:00:00,108213,10687,12292,9224,2079,6807,149302
2020-10-07,07:30:00,114834,12583,14328,10482,3212,9713,165152
2020-10-07,08:00:00,125091,13054,15794,12356,2720,11615,180630
2020-10-07,08:30:00,132928,14494,17455,14480,3914,14167,197438
2020-10-07,09:00:00,137355,15124,18854,15041,4248,16344,206966
2020-10-07,09:30:00,138926,17820,20952,16479,5116,17631,216924
2020-10-07,10:00:00,135255,17385,19779,14984,4783,16148,208334
2020-10-07,10:30:00,132874,16709,19496,14083,4313,14994,202469
2020-10-07,11:00:00,133494,16986,20321,15019,5172,16791,207783
2020-10-07,11:30:00,117059,14848,17017,13047,4409,13339,179719
2020-10-07,12:00:00,135574,16324,18808,13646,5176,15277,204805
2020-10-07,12:30:00,134643,17222,20266,14748,5464,15790,208133
2020-10-07,13:00:00,136922,17978,20466,15383,5718,17040,213507
2020-10-07,13:30:00,138826,18096,21161,16498,4878,15938,215397
2020-10-07,14:00:00,136179,18054,21039,16084,5088,16553,212997
2020-10-07,14:30:00,136442,18337,20468,14715,5680,15077,210719
2020-10-07,15:00:00,136898,16787,19084,14162,5286,14532,206749
2020-10-07,15:30:00,137067,17206,20264,14747,5391,16190,210865
2020-10-07,16:00:00,134302,17721,21011,15768,5718,17176,211696
2020-10-07,16:30:00,136307,18193,21481,16675,5649,17837,216142
2020-10-07,17:00:00,136521,18928,22637,17710,6312,18731,220839
2020-10-07,17:30:00,139205,18690,22558,17548,6070,19241,223312
2020-10-07,18:00:00,136937,18010,23768,18703,6515,19316,223249
2020-10-07,18:30:00,143287,20090,25041,20350,6829,20429,236026
2020-10-07,19:00:00,144096,19837,25521,19971,7240,20218,236883
2020-10-07,19:30:00,146970,20718,25332,19202,7308,20637,240167
2020-10-07,20:00:00,138896,18179,21513,15983,6497,16661,217729
2020-10-07,20:30:00,138213,17345,20510,14500,6488,16041,213097
2020-10-07,21:00:00,130241,15607,18744,13715,5427,13854,197588
2020-10-07,21:30:00,127488,15065,17910,12758,5428,12877,191526
2020-10-07,22:00:00,128978,15597,18030,12343,5355,11606,191909
2020-10-07,22:30:00,129792,15926,17182,12509,5459,12095,192963
2020-10-07,23:00:00,123095,14467,16432,12106,4736,12301,183137
2020-10-07,23:30:00,123029,14501,16497,12234,4722,12342,183325
2020-10-08,00:00:00,119832,13430,15341,11024,4696,11014,175337
2020-10-08,00:30:00,119383,12088,15029,10915,3649,12379,173443
2020-10-08,01:00:00,113786,13666,15859,9321,3351,11089,167072
2020-10-08,01:30:00,110278,13891,15401,7640,3861,8421,159492
2020-10-08,02:00:00,102271,14871,16224,7943,3939,7864,153112
2020-10-08,02:30:00,97295,15311,14496,7327,1909,966,137304
2020-10-08,03:00:00,90248,14398,13470,7760,1627,950,128453
2020-10-08,03:30:00,85960,14679,12134,7217,2000,897,122887
2020-10-08,04:00:00,84538,14597,12461,7754,1774,834,121958
2020-10-08,04:30:00,84571,14855,12071,7128,1674,811,121110
2020-10-08,05:00:00,82213,14073,11439,6851,1697,808,117081
2020-10-08,05:30:00,82233,14127,11899,7189,1659,681,117788
2020-10-08,06:00:00,84632,14646,12909,8236,1401,1002,122826
2020-10-08,06:30:00,100126,12254,12496,8695,1394,6583,141548
2020-10-08,07:00:00,106828,11095,12332,9205,2000,7522,148982
2020-10-08,07:30:00,112156,11560,13330,11078,2441,8636,159201
2020-10-08,08:00:00,123788,13002,15336,12936,2888,10259,178209
2020-10-08,08:30:00,133016,14863,16923,14265,4116,14558,197741
2020-10-08,09:00:00,138904,16725,20465,15903,5104,16274,213375
2020-10-08,09:30:00,142311,19273,21678,16718,6391,17312,223683
2020-10-08,10:00:00,139462,19393,21198,15679,5932,16465,218129
2020-10-08,10:30:00,136726,17601,19299,14642,5471,15380,209119
2020-10-08,11:00:00,133166,17147,18717,13565,5475,14668,202738
2020-10-08,11:30:00,134479,18392,19637,14304,4409,14773,205994
2020-10-08,12:00:00,133811,17670,19812,14803,5261,14897,206254
2020-10-08,12:30:00,135827,18452,21265,16017,5533,17306,214400
2020-10-08,13:00:00,136875,18577,20325,15399,5140,16572,212888
2020-10-08,13:30:00,136696,18234,20698,15866,5721,17140,214355
2020-10-08,14:00:00,136038,17798,20090,15357,5837,17019,212139
2020-10-08,14:30:00,132843,17969,19930,14504,5780,15240,206266
2020-10-08,15:00:00,135773,18207,19091,14008,5931,15265,208275
2020-10-08,15:30:00,132169,17558,19391,14453,5714,15433,204718
2020-10-08,16:00:00,132303,17397,17831,13949,5330,14883,201693
2020-10-08,16:30:00,135019,17786,20930,16572,5545,17347,213199
2020-10-08,17:00:00,137684,18455,22474,17569,6051,18160,220393
2020-10-08,17:30:00,135744,18018,21568,17932,5897,18717,217876
2020-10-08,18:00:00,134686,18699,22263,17895,6575,19253,219371
2020-10-08,18:30:00,141135,18195,23204,19106,7048,20317,229005
2020-10-08,19:00:00,160951,19568,28990,25184,7776,27637,270106
2020-10-08,19:30:00,155716,20918,27942,19484,7107,19570,250737
2020-10-08,20:00:00,153758,21015,22648,22631,6105,17849,244006
2020-10-08,20:30:00,140399,17529,21008,19754,7521,16228,222439
2020-10-08,21:00:00,145724,18055,22382,17267,5601,13092,222121
2020-10-08,21:30:00,133724,16937,19705,14356,6257,15841,206820
2020-10-08,22:00:00,130790,16815,18327,13028,6391,14168,199519
2020-10-08,22:30:00,129409,15257,17791,13239,6006,14014,195716
2020-10-08,23:00:00,127653,16211,18124,13950,5174,14220,195332
2020-10-08,23:30:00,123551,14933,17127,13237,5410,13335,187593
2020-10-09,00:00:00,122296,14447,16739,12148,5367,13764,184761
2020-10-09,00:30:00,120703,14242,16218,10960,3444,12645,178212
2020-10-09,01:00:00,113999,11704,13618,9442,1238,12553,162554
2020-10-09,01:30:00,110944,11079,13094,9275,2008,11494,157894
2020-10-09,02:00:00,104658,13964,14336,8563,2722,8097,152340
2020-10-09,02:30:00,103117,13506,14006,7885,2412,4543,145469
2020-10-09,03:00:00,97862,16245,15091,8330,2596,2685,142809
2020-10-09,03:30:00,92004,14272,14423,9332,2180,926,133137
2020-10-09,04:00:00,85749,13876,13504,9099,1656,926,124810
2020-10-09,04:30:00,84544,14556,13442,8177,1868,940,123527
2020-10-09,05:00:00,86829,14487,13550,8357,1986,863,126072
2020-10-09,05:30:00,86192,12732,11383,8559,2808,1160,122834
2020-10-09,06:00:00,87504,11240,9724,9887,2841,1112,122308
2020-10-09,06:30:00,101767,11864,12613,9614,2636,5425,143919
2020-10-09,07:00:00,106494,11031,13279,9034,2442,7593,149873
2020-10-09,07:30:00,115095,11926,14452,10439,2864,9057,163833
2020-10-09,08:00:00,123165,12756,16126,13101,3364,11993,180505
2020-10-09,08:30:00,130665,13097,16779,13469,3970,14440,192420
2020-10-09,09:00:00,139591,16549,19575,15794,5004,17475,213988
2020-10-09,09:30:00,136938,17094,20452,15838,5511,17277,213110
2020-10-09,10:00:00,136584,17845,20218,14005,5549,15725,209926
2020-10-09,10:30:00,135426,16424,20032,14709,5456,16368,208415
2020-10-09,11:00:00,135309,16413,19714,15479,5137,16787,208839
2020-10-09,11:30:00,131716,16419,20061,15385,4668,17334,205583
2020-10-09,12:00:00,135966,17984,21101,15866,5134,17074,213125
2020-10-09,12:30:00,136004,17661,21295,16826,4928,18061,214775
2020-10-09,13:00:00,136154,17620,22446,18547,5487,16691,216945
2020-10-09,13:30:00,139492,18899,20752,16196,5769,16395,217503
2020-10-09,14:00:00,138403,18121,21156,16057,5705,16819,216261
2020-10-09,14:30:00,132841,17921,21126,16646,5291,16830,210655
2020-10-09,15:00:00,130317,16285,19602,14817,5561,15206,201788
2020-10-09,15:30:00,129494,17035,21087,16229,5616,15455,204916
2020-10-09,16:00:00,131951,15621,20209,16105,5710,17141,206737
2020-10-09,16:30:00,139127,18424,23430,18088,6097,19325,224491
2020-10-09,17:00:00,136117,18670,24483,20294,6396,18091,224051
2020-10-09,17:30:00,138747,18858,24923,17966,6220,20948,227662
2020-10-09,18:00:00,135410,17207,23293,19065,6342,19311,220628
2020-10-09,18:30:00,138095,19227,24196,19962,6415,19705,227600
2020-10-09,19:00:00,140529,20079,24717,20512,6062,21054,232953
2020-10-09,19:30:00,143468,21167,25460,20235,7068,21057,238455
2020-10-09,20:00:00,146046,19579,24834,20632,6247,20335,237673
2020-10-09,20:30:00,142498,18693,22824,19002,6384,17819,227220
2020-10-09,21:00:00,136679,16794,20756,17435,5844,15184,212692
2020-10-09,21:30:00,135562,16662,19200,12211,5411,14277,203323
2020-10-09,22:00:00,131371,15946,17769,14801,4544,13954,198385
2020-10-09,22:30:00,130074,15559,18230,12828,4576,13272,194539
2020-10-09,23:00:00,128803,14744,18343,14326,4706,14076,194998
2020-10-09,23:30:00,128827,14415,17078,13049,4653,12582,190604
2020-10-10,00:00:00,128202,14970,16257,12665,3944,12839,188877
2020-10-10,00:30:00,125880,15359,16303,10687,4169,12044,184442
2020-10-10,01:00:00,118817,13766,14505,9696,3633,12444,172861
2020-10-10,01:30:00,114338,13100,12575,9273,2435,12078,163799
2020-10-10,02:00:00,108520,12137,12352,8977,2739,10245,154970
2020-10-10,02:30:00,109437,14096,9223,7894,3218,9236,153104
2020-10-10,03:00:00,107553,14285,8942,7365,2208,8517,148870
2020-10-10,03:30:00,103678,16303,9748,6531,1972,8583,146815
2020-10-10,04:00:00,99878,15501,8339,7493,2094,3982,137287
2020-10-10,04:30:00,97211,15043,8010,7151,2411,1466,131292
2020-10-10,05:00:00,95511,14973,7716,7591,2042,1392,129225
2020-10-10,05:30:00,92592,15095,7515,3276,1868,1714,122060
2020-10-10,06:00:00,96419,16564,8576,2693,2200,1550,128002
2020-10-10,06:30:00,101141,13110,11840,8501,1968,6720,143280
2020-10-10,07:00:00,100664,9630,10446,8376,1829,7261,138206
2020-10-10,07:30:00,101608,9850,11473,9765,1754,8635,143085
2020-10-10,08:00:00,105342,10139,10998,8775,1953,8367,145574
2020-10-10,08:30:00,108031,11057,12133,9362,2257,9269,152109
2020-10-10,09:00:00,115046,12432,14646,12024,3163,11144,168455
2020-10-10,09:30:00,120406,14305,15870,12057,3653,11197,177488
2020-10-10,10:00:00,125255,15485,18799,14487,3813,13901,191740
2020-10-10,10:30:00,127958,15652,19375,15068,4450,15029,197532
2020-10-10,11:00:00,130344,16026,20469,15774,4492,15108,202213
2020-10-10,11:30:00,132831,17093,22416,13047,4721,16932,207040
2020-10-10,12:00:00,133309,17652,20695,16028,4954,16989,209627
2020-10-10,12:30:00,132340,17519,22203,17603,4934,17249,211848
2020-10-10,13:00:00,132995,15646,21277,17729,5136,16527,209310
2020-10-10,13:30:00,131200,16812,21006,16534,4584,16199,206335
2020-10-10,14:00:00,130201,17794,20399,17151,5646,15576,206767
2020-10-10,14:30:00,132918,17761,20407,15455,5477,17167,209185
2020-10-10,15:00:00,132295,17818,19795,15000,5407,15171,205486
2020-10-10,15:30:00,133616,17642,22353,17502,5825,16067,213005
2020-10-10,16:00:00,131166,18356,22471,17769,5209,16810,211781
2020-10-10,16:30:00,133664,17654,22650,18231,5363,17958,215520
2020-10-10,17:00:00,136551,18780,24032,20138,5681,18703,223885
2020-10-10,17:30:00,130292,19816,24169,19076,6239,18953,218545
2020-10-10,18:00:00,133851,18975,23631,18149,6289,17885,218780
2020-10-10,18:30:00,135882,20189,25007,19866,6660,19023,226627
2020-10-10,19:00:00,136093,18991,23500,18097,5717,18265,220663
2020-10-10,19:30:00,137739,18780,23628,18395,5794,17040,221376
2020-10-10,20:00:00,137323,16758,22021,17782,5602,15672,215158
2020-10-10,20:30:00,133603,15659,20426,16617,4926,14551,205782
2020-10-10,21:00:00,120044,14795,17279,13448,5601,13092,184259
2020-10-10,21:30:00,116108,14135,16264,12211,4360,11751,174829
2020-10-10,22:00:00,130697,15968,18237,13834,4077,10685,193498
2020-10-10,22:30:00,128962,16048,17819,13095,4265,11053,191242
2020-10-10,23:00:00,126482,16009,17137,12971,4286,11009,187894
2020-10-10,23:30:00,125638,15580,16781,13016,3928,11673,186616
2020-10-11,00:00:00,124795,15151,16426,13062,3570,12338,185342
2020-10-11,00:30:00,124811,14459,16281,10657,3703,12690,182601
2020-10-11,01:00:00,120736,13912,14050,11187,2676,12722,175283
2020-10-11,01:30:00,112377,12391,11680,9601,1713,12088,159850
2020-10-11,02:00:00,107881,12945,12283,9323,2302,9630,154364
2020-10-11,02:30:00,102605,13921,11785,8565,2114,8876,147866
2020-10-11,03:00:00,98939,16443,8751,6928,2243,9486,142790
2020-10-11,03:30:00,95839,14354,8204,6996,2073,11021,138487
2020-10-11,04:00:00,91262,14157,7925,6935,1959,3267,125505
2020-10-11,04:30:00,92636,13950,7724,6350,1830,9641,132131
2020-10-11,05:00:00,88566,15667,6936,6357,1610,11740,130876
2020-10-11,05:30:00,87144,16135,7317,4565,1989,3135,120285
2020-10-11,06:00:00,87828,16444,7771,2343,2018,2948,119352
2020-10-11,06:30:00,99764,12785,10694,7418,2232,8408,141301
2020-10-11,07:00:00,103963,9535,10130,8856,1689,6494,140667
2020-10-11,07:30:00,96557,9610,10442,10292,1611,7340,135852
2020-10-11,08:00:00,97442,9846,10593,8105,1788,6758,134532
2020-10-11,08:30:00,100242,9855,10580,8583,3427,12798,145485
2020-10-11,09:00:00,129716,11095,11720,13893,2116,14706,183246
2020-10-11,09:30:00,112216,16505,12997,10139,2634,9063,163554
2020-10-11,10:00:00,116145,12905,14114,10447,3196,10095,166902
2020-10-11,10:30:00,120740,14761,15588,11354,4243,15010,181696
2020-10-11,11:00:00,127632,16550,19010,14164,4264,13175,194795
2020-10-11,11:30:00,129979,17675,18610,14410,4685,13411,198770
2020-10-11,12:00:00,134056,19041,20615,14994,4740,14434,207880
2020-10-11,12:30:00,126577,16311,19084,14584,4810,15247,196613
2020-10-11,13:00:00,134123,17589,20564,15537,5194,16691,209698
2020-10-11,13:30:00,132987,18830,20935,14946,4927,16395,209020
2020-10-11,14:00:00,134627,17354,20213,14480,6009,15870,208553
2020-10-11,14:30:00,129214,16801,20200,15304,4981,12755,199255
2020-10-11,15:00:00,131107,17509,20941,15175,6016,15171,205919
2020-10-11,15:30:00,133450,16958,20004,14581,5942,15097,206032
2020-10-11,16:00:00,138443,18631,21636,14987,6334,15867,215898
2020-10-11,16:30:00,134444,19439,22001,16334,6247,17159,215624
2020-10-11,17:00:00,136797,18565,22732,17453,5696,18091,219334
2020-10-11,17:30:00,135054,17383,22611,17385,5505,15424,213362
2020-10-11,18:00:00,135232,17833,22784,16556,6143,18810,217358
2020-10-11,18:30:00,139221,18035,22433,19778,6386,20042,225895
2020-10-11,19:00:00,140188,18278,20623,16111,5681,13880,214761
2020-10-11,19:30:00,139508,18018,21145,19484,5387,13929,217471
2020-10-11,20:00:00,139805,17261,19904,14957,4956,13899,210782
2020-10-11,20:30:00,139832,16603,19068,14332,5564,13501,208900
2020-10-11,21:00:00,141703,17277,19799,14592,5304,13897,212572
2020-10-11,21:30:00,136713,16342,18416,13018,4612,11861,200962
2020-10-11,22:00:00,135607,16431,17675,12370,4842,12803,199728
2020-10-11,22:30:00,129792,15791,17699,12560,4348,12648,192838
2020-10-11,23:00:00,134309,15299,16261,11396,3731,11683,192679
2020-10-11,23:30:00,132149,14116,16318,11680,4086,12240,190589
2020-10-12,00:00:00,128670,13029,15578,10131,3283,11355,182046
2020-10-12,00:30:00,123822,11762,12780,10657,3750,10783,173554
2020-10-12,01:00:00,118974,10495,11873,7965,1712,10212,161231
2020-10-12,01:30:00,115787,11246,11964,7965,1209,8723,156894
2020-10-12,02:00:00,113289,10674,11071,7960,1563,7966,152523
2020-10-12,02:30:00,112603,12734,11557,7770,1539,5501,151704
2020-10-12,03:00:00,108172,14339,12404,7859,1758,5629,150161
2020-10-12,03:30:00,99678,14396,12729,8112,1541,5566,142022
2020-10-12,04:00:00,96547,14363,12393,7704,1691,5131,137829
2020-10-12,04:30:00,107228,13518,13930,9539,2224,9246,155685
2020-10-12,05:00:00,89279,10652,12618,7591,2322,10758,133220
2020-10-12,05:30:00,98664,12092,7795,11145,2228,6551,138475
2020-10-12,06:00:00,94554,3173,8000,10869,3338,5824,125758
2020-10-12,06:30:00,100646,11794,11431,8939,3041,7091,142942
2020-10-12,07:00:00,104665,9971,10429,9602,2907,7659,145233
2020-10-12,07:30:00,108307,11292,12297,10828,3299,11267,157290
2020-10-12,08:00:00,126231,12299,13419,13303,3177,13547,181976
2020-10-12,08:30:00,132335,13159,14569,13407,4035,15401,192906
2020-10-12,09:00:00,135878,16103,17572,14539,5325,16504,205921
2020-10-12,09:30:00,140848,16937,18984,14985,5415,16449,213618
2020-10-12,10:00:00,135611,15099,15991,12819,4802,15038,199360
2020-10-12,10:30:00,131806,13435,15100,12022,4743,14120,191226
2020-10-12,11:00:00,128868,16181,19127,14362,4491,13542,196571
2020-10-12,11:30:00,133228,15243,16316,12429,4984,13892,196092
2020-10-12,12:00:00,134163,15990,16694,12828,4889,14533,199097
2020-10-12,12:30:00,135274,16512,18094,13802,5161,14516,203359
2020-10-12,13:00:00,135103,16074,17900,14763,4988,16041,204869
2020-10-12,13:30:00,136499,16526,20752,15713,5045,16282,210817
2020-10-12,14:00:00,137654,16304,20399,14030,5177,15754,209318
2020-10-12,14:30:00,140094,17338,20407,13580,5514,14539,211472
2020-10-12,15:00:00,135992,16173,18269,14208,4536,15913,205091
2020-10-12,15:30:00,137448,17206,19820,12797,5666,14353,207290
2020-10-12,16:00:00,137195,16567,18199,14342,5027,16175,207505
2020-10-12,16:30:00,137465,15761,18842,14685,4583,16641,207977
2020-10-12,17:00:00,136551,16044,19512,15465,5595,17625,210792
2020-10-12,17:30:00,135730,16926,19443,17966,5448,16950,212463
2020-10-12,18:00:00,140951,17580,21316,17557,6479,18551,222434
2020-10-12,18:30:00,144709,19226,24774,20450,6538,22477,238174
2020-10-12,19:00:00,141095,16973,20414,17071,5763,17433,218749
2020-10-12,19:30:00,145386,18183,23358,18663,6085,18580,230255
2020-10-12,20:00:00,148855,18781,21919,17726,5687,17744,230712
2020-10-12,20:30:00,141519,17042,20279,15873,6194,15793,216700
2020-10-12,21:00:00,136832,16336,17459,13872,5839,13010,203348
2020-10-12,21:30:00,135560,15871,18220,13848,5737,13131,202367
2020-10-12,22:00:00,133092,16010,16985,13324,5477,13376,198264
2020-10-12,22:30:00,131041,15598,16723,12738,3989,12387,192476
2020-10-12,23:00:00,134086,15826,16504,13062,4417,12706,196601
2020-10-12,23:30:00,131994,14807,15884,12482,4465,12505,192137
2020-10-13,00:00:00,124927,13590,13817,10470,3767,11304,177875
2020-10-13,00:30:00,120829,12718,12638,9756,3289,10086,169316
2020-10-13,01:00:00,116320,13002,11778,7552,2737,9743,161132
2020-10-13,01:30:00,117002,11903,10736,8089,1524,10910,160164
2020-10-13,02:00:00,116166,13031,11399,8640,2228,10616,162080
2020-10-13,02:30:00,111040,14749,12401,8180,2665,6689,155724
2020-10-13,03:00:00,106405,12110,12142,8003,2575,3895,145130
2020-10-13,03:30:00,99439,7662,11562,7520,2757,3378,132318
2020-10-13,04:00:00,101052,8133,12075,7681,2986,3663,135590
2020-10-13,04:30:00,100218,8242,12084,7916,2951,3679,135090
2020-10-13,05:00:00,99385,8352,12094,7692,2917,3696,134136
2020-10-13,05:30:00,99556,7973,11987,8084,2352,3549,133501
2020-10-13,06:00:00,100196,7898,12023,7847,2306,3605,133875
2020-10-13,06:30:00,109513,11698,12531,8935,2624,8527,153828
2020-10-13,07:00:00,114309,10657,11958,9115,2476,8974,157489
2020-10-13,07:30:00,117623,11527,13447,12035,2692,11165,168489
2020-10-13,08:00:00,125589,12302,14169,12552,3168,13797,181577
2020-10-13,08:30:00,135480,13226,15139,13677,3556,15169,196247
2020-10-13,09:00:00,141262,15869,19939,17222,5342,18080,217714
2020-10-13,09:30:00,146828,17587,19873,15991,5727,17458,223464
2020-10-13,10:00:00,142290,16788,18360,14841,5403,16102,213784
2020-10-13,10:30:00,140845,16841,18154,13537,5206,15409,209992
2020-10-13,11:00:00,136502,16786,17786,13422,5038,14235,203769
2020-10-13,11:30:00,133815,17067,17599,13787,5361,13903,201532
2020-10-13,12:00:00,134419,16182,16790,14242,5215,14320,201168
2020-10-13,12:30:00,136489,15684,17164,13705,5165,15388,203595
2020-10-13,13:00:00,139415,16902,18143,14591,5085,15758,209894
2020-10-13,13:30:00,138012,17590,21009,16469,5470,16032,214582
2020-10-13,14:00:00,136841,16986,19120,14952,5199,15325,208423
2020-10-13,14:30:00,134784,16573,19826,15635,5224,15487,207529
2020-10-13,15:00:00,137988,16673,19506,15376,5425,15403,210371
2020-10-13,15:30:00,138306,16011,17628,13921,4757,15752,206375
2020-10-13,16:00:00,135738,15192,17766,14308,5388,15782,204174
2020-10-13,16:30:00,140490,16913,19921,16135,5648,16860,215967
2020-10-13,17:00:00,142496,17339,20764,16820,5443,18343,221205
2020-10-13,17:30:00,143607,18913,23602,20387,5437,20529,232475
2020-10-13,18:00:00,148700,19181,23616,20590,5512,22840,240439
2020-10-13,18:30:00,149431,19525,23915,20378,5778,22263,241290
2020-10-13,19:00:00,145997,19473,23950,20072,5709,21006,236207
2020-10-13,19:30:00,157206,21980,26463,21656,6501,23531,257337
2020-10-13,20:00:00,156732,20524,24866,21896,6543,22429,252990
2020-10-13,20:30:00,144523,17748,20806,16371,6216,17319,222983
2020-10-13,21:00:00,142808,17730,21381,16650,7276,15426,221271
2020-10-13,21:30:00,138068,16536,19003,13827,5598,14260,207292
2020-10-13,22:00:00,135269,15278,17869,13435,5238,12875,199964
2020-10-13,22:30:00,132326,15465,17748,12719,5101,11445,194804
2020-10-13,23:00:00,130717,15340,16142,12556,4879,13385,193019
2020-10-13,23:30:00,131974,14067,15529,11253,4496,12276,189595
2020-10-14,00:00:00,130151,14005,14771,10955,4249,11297,185428
2020-10-14,00:30:00,128594,13442,15314,10996,3282,11532,183160
2020-10-14,01:00:00,121784,11648,11768,8904,2365,11513,167982
2020-10-14,01:30:00,121186,11604,12391,9550,2598,11497,168826
2020-10-14,02:00:00,116643,14479,13594,8080,3110,9807,165713
2020-10-14,02:30:00,115181,15888,14135,8317,2910,5956,162387
2020-10-14,03:00:00,110811,15088,12564,8051,2171,6108,154793
2020-10-14,03:30:00,107420,15141,12622,8357,2748,5510,151798
2020-10-14,04:00:00,107545,15739,12590,8772,2718,3267,150631
2020-10-14,04:30:00,106041,15482,12068,7888,2571,3151,147201
2020-10-14,05:00:00,104074,15431,11730,7698,2494,3053,144480
2020-10-14,05:30:00,103731,14068,10314,8108,3142,3323,142686
2020-10-14,06:00:00,105673,11251,7496,9036,3344,3735,140535
2020-10-14,06:30:00,109296,11381,11412,9478,2775,7477,151819
2020-10-14,07:00:00,115749,10459,12422,10235,2720,9004,160589
2020-10-14,07:30:00,120441,10996,13495,11713,3304,11168,171117
2020-10-14,08:00:00,129816,11441,14474,12988,3368,13358,185445
2020-10-14,08:30:00,136652,13592,16345,13433,4798,15067,199887
2020-10-14,09:00:00,142892,15719,18508,16737,4687,17298,215841
2020-10-14,09:30:00,143707,16268,19452,15276,4753,17549,217005
2020-10-14,10:00:00,141592,16702,18984,13853,5346,16052,212529
2020-10-14,10:30:00,139114,17384,19722,13482,5647,14135,209484
2020-10-14,11:00:00,139123,18285,19577,13366,5664,15070,211085
2020-10-14,11:30:00,139313,16835,20932,15149,6478,16771,215478
2020-10-14,12:00:00,137562,17421,19631,14282,5433,15074,209403
2020-10-14,12:30:00,137070,17501,19966,14542,6364,15830,211273
2020-10-14,13:00:00,143070,19735,22508,18004,5525,19998,228840
2020-10-14,13:30:00,149665,19891,23386,18330,5930,19622,236824
2020-10-14,14:00:00,150536,20042,24433,19441,6750,21161,242363
2020-10-14,14:30:00,134229,19647,19884,17141,6623,17825,215349
2020-10-14,15:00:00,144801,19291,22459,17450,6678,17103,227782
2020-10-14,15:30:00,140028,18385,20881,14985,6346,17118,217743
2020-10-14,16:00:00,143357,18672,22349,16579,5388,18144,224489
2020-10-14,16:30:00,146934,19194,24638,19122,5793,19404,235085
2020-10-14,17:00:00,148827,19184,23749,18694,5443,20084,235981
2020-10-14,17:30:00,148796,20259,24508,19595,6921,20962,241041
2020-10-14,18:00:00,151077,19479,23233,18694,6769,20587,239839
2020-10-14,18:30:00,150959,18313,23157,19129,5973,21285,238816
2020-10-14,19:00:00,165405,21153,28590,22848,7961,24731,270688
2020-10-14,19:30:00,165217,20758,25821,20684,6158,23273,261911
2020-10-14,20:00:00,162028,19078,23082,18921,6284,20298,249691
2020-10-14,20:30:00,154116,18572,20933,16343,5695,18274,233933
2020-10-14,21:00:00,150483,17618,21760,17148,6622,16387,230018
2020-10-14,21:30:00,145885,16766,20783,15886,6051,15898,221269
2020-10-14,22:00:00,142156,16524,19104,14633,4567,14893,211877
2020-10-14,22:30:00,139997,16401,19339,13418,5275,12803,207233
2020-10-14,23:00:00,139102,14112,18662,13699,5214,13045,203834
2020-10-14,23:30:00,133509,14629,17542,13246,5127,13411,197464
2020-10-15,00:00:00,134058,15078,18496,13584,4755,13602,199573
2020-10-15,00:30:00,128476,13535,17298,12588,4072,14479,190448
2020-10-15,01:00:00,124193,12755,12506,10218,3456,13212,176340
2020-10-15,01:30:00,119707,12306,13388,10439,2403,11399,169642
2020-10-15,02:00:00,118899,13276,13745,9896,3455,8875,168146
2020-10-15,02:30:00,112828,13262,12636,9045,3066,8301,159138
2020-10-15,03:00:00,107157,15333,12989,8303,2539,6395,152716
2020-10-15,03:30:00,104405,14724,12420,7984,2866,5090,147489
2020-10-15,04:00:00,102459,13623,11059,7289,2176,4503,141109
2020-10-15,04:30:00,103123,13494,12027,7894,2668,3387,142593
2020-10-15,05:00:00,101510,12568,11444,8630,2921,3748,140821
2020-10-15,05:30:00,100110,11063,11192,7733,2765,3803,136666
2020-10-15,06:00:00,103045,11889,6840,8328,2714,3925,136741
2020-10-15,06:30:00,109282,12548,12581,9191,3311,8416,155329
2020-10-15,07:00:00,111181,11155,11988,9055,2593,9711,155683
2020-10-15,07:30:00,118920,12622,13687,11528,2942,11845,171544
2020-10-15,08:00:00,128284,12582,15480,12482,4074,13307,186209
2020-10-15,08:30:00,136853,15599,17698,13920,4727,15730,204527
2020-10-15,09:00:00,143083,16822,20297,16301,5211,18157,219871
2020-10-15,09:30:00,143694,16954,20820,16201,5688,19212,222569
2020-10-15,10:00:00,142622,16691,20224,14684,4746,16925,215892
2020-10-15,10:30:00,140783,17158,20632,15454,5257,17520,216804
2020-10-15,11:00:00,142058,17264,20573,15135,4701,17412,217143
2020-10-15,11:30:00,139174,16250,19473,14475,4893,16387,210652
2020-10-15,12:00:00,136441,16915,19608,14636,5464,16044,209108
2020-10-15,12:30:00,139608,18052,20834,15242,6273,17800,217809
2020-10-15,13:00:00,140883,18037,21273,16548,5350,17561,219652
2020-10-15,13:30:00,140632,17039,21347,16407,5829,17690,218944
2020-10-15,14:00:00,144423,17546,22351,16679,5882,16818,223699
2020-10-15,14:30:00,137012,16573,19662,14287,5385,15657,208576
2020-10-15,15:00:00,134819,15632,18499,13548,5698,15819,204015
2020-10-15,15:30:00,134858,16452,19033,13717,5849,15956,205865
2020-10-15,16:00:00,135997,16700,19290,14942,5543,16564,209036
2020-10-15,16:30:00,140081,16735,20027,15283,5717,18422,216265
2020-10-15,17:00:00,140090,16551,19959,16302,5462,18571,216935
2020-10-15,17:30:00,141528,18936,23225,18339,6048,20440,228516
2020-10-15,18:00:00,151712,20217,24693,20539,6786,22614,246561
2020-10-15,18:30:00,151556,20097,25905,21391,6940,24086,249975
2020-10-15,19:00:00,150562,21325,27150,22830,7513,23679,253059
2020-10-15,19:30:00,152141,19178,26054,21853,6286,22335,247847
2020-10-15,20:00:00,145009,19779,24035,18666,7453,18320,233262
2020-10-15,20:30:00,138110,17988,21776,16068,6306,15459,215707
2020-10-15,21:00:00,135131,16811,19692,14527,5481,15100,206742
2020-10-15,21:30:00,132403,16014,18452,13595,5195,13358,199017
2020-10-15,22:00:00,129506,15697,17870,12811,5448,12418,193750
2020-10-15,22:30:00,131012,16310,18198,12686,5370,11926,195502
2020-10-15,23:00:00,130221,15223,17228,11854,4775,12504,191805
2020-10-15,23:30:00,130496,15363,16276,11736,4407,12300,190578
2020-10-16,00:00:00,128318,14918,16856,11414,4796,12479,188781
2020-10-16,00:30:00,126986,13572,15348,11603,4254,13365,185128
2020-10-16,01:00:00,124375,11314,12291,10551,2140,13479,174150
2020-10-16,01:30:00,116288,11799,13967,10098,3748,11202,167102
2020-10-16,02:00:00,114985,14539,15500,8946,3961,9868,167799
2020-10-16,02:30:00,114562,9991,13762,9145,3402,4395,155257
2020-10-16,03:00:00,111419,10224,14495,8135,2753,4122,151148
2020-10-16,03:30:00,110661,10333,14413,9291,2878,4128,151704
2020-10-16,04:00:00,105225,9261,13047,8001,3012,3750,142296
2020-10-16,04:30:00,103612,9036,12397,7997,3130,3512,139684
2020-10-16,05:00:00,101925,8685,11779,7713,2598,3464,136164
2020-10-16,05:30:00,102030,9234,12758,7939,2807,3550,138318
2020-10-16,06:00:00,105231,9275,12972,8299,2734,3907,142418
2020-10-16,06:30:00,109273,11019,12562,9195,2673,8811,153533
2020-10-16,07:00:00,109139,10544,12052,9328,2911,9217,153191
2020-10-16,07:30:00,119486,11364,12976,10921,3388,11071,169206
2020-10-16,08:00:00,127722,12718,14689,12292,3656,11816,182893
2020-10-16,08:30:00,133708,14025,16358,12904,4164,14573,195732
2020-10-16,09:00:00,135640,17263,18056,13855,5859,15687,206360
2020-10-16,09:30:00,143040,19094,19965,15473,5655,18266,221493
2020-10-16,10:00:00,140433,17900,19784,15625,4720,17050,215512
2020-10-16,10:30:00,137153,18194,19604,14205,5100,16178,210434
2020-10-16,11:00:00,136313,18405,20805,14316,5508,16396,211743
2020-10-16,11:30:00,135382,17031,18558,13541,5542,15444,205498
2020-10-16,12:00:00,136920,18538,20694,14613,5636,15441,211842
2020-10-16,12:30:00,141579,19616,21003,15519,6109,16737,220563
2020-10-16,13:00:00,140651,18505,20983,17061,5270,18454,220924
2020-10-16,13:30:00,140770,19064,22129,17511,5814,18077,223365
2020-10-16,14:00:00,138854,18948,22651,17518,5617,18731,222319
2020-10-16,14:30:00,134560,17889,20511,15859,5753,16278,210850
2020-10-16,15:00:00,132834,17907,19800,15237,5175,16454,207407
2020-10-16,15:30:00,138035,16613,22174,17671,5748,15724,215965
2020-10-16,16:00:00,140289,19487,23421,15178,5120,20415,223910
2020-10-16,16:30:00,140506,18858,22861,18925,5132,20804,227086
2020-10-16,17:00:00,139979,19254,23654,19560,5486,21131,229064
2020-10-16,17:30:00,139222,18871,23857,20055,5911,21184,229100
2020-10-16,18:00:00,144139,19916,25390,20512,6966,20734,237657
2020-10-16,18:30:00,138349,19236,23037,18942,5897,21255,226716
2020-10-16,19:00:00,145594,18863,24476,20143,6006,21638,236720
2020-10-16,19:30:00,142661,19015,24088,19290,6180,20399,231633
2020-10-16,20:00:00,137178,17143,21977,17715,5205,17719,216937
2020-10-16,20:30:00,132847,15977,19928,16067,5021,15259,205099
2020-10-16,21:00:00,130343,15104,18080,14398,4677,14385,196987
2020-10-16,21:30:00,128001,15962,19190,14229,4904,14824,197110
2020-10-16,22:00:00,124811,15205,17604,13153,4699,14085,189557
2020-10-16,22:30:00,126783,14628,17059,13253,4241,13155,189119
2020-10-16,23:00:00,125105,14759,16916,13129,3886,13035,186830
2020-10-16,23:30:00,128670,15437,17146,13652,4057,13760,192722
2020-10-17,00:00:00,130703,15990,16933,12737,4242,13676,194281
2020-10-17,00:30:00,126385,14248,15442,11506,4188,13393,185162
2020-10-17,01:00:00,121282,12005,12684,9464,2097,12536,170068
2020-10-17,01:30:00,119870,11358,11588,8750,1800,11482,164848
2020-10-17,02:00:00,113317,10458,11254,8817,1662,11964,157472
2020-10-17,02:30:00,107815,9979,11269,8464,2783,10914,151224
2020-10-17,03:00:00,105156,9598,13903,8241,2723,5623,145244
2020-10-17,03:30:00,102197,8886,13288,8479,2847,4118,139815
2020-10-17,04:00:00,97394,8459,12609,8041,2813,3940,133256
2020-10-17,04:30:00,94793,8932,12803,7888,2630,3840,130886
2020-10-17,05:00:00,92188,8321,11814,6872,2356,3554,125105
2020-10-17,05:30:00,90812,7776,11722,7929,2749,3669,124657
2020-10-17,06:00:00,90867,4001,7757,9016,3436,4298,119375
2020-10-17,06:30:00,100392,10428,12337,10267,3050,7714,144188
2020-10-17,07:00:00,98407,10288,11673,8954,2852,8402,140576
2020-10-17,07:30:00,100795,9545,10933,8922,2488,8870,141553
2020-10-17,08:00:00,102499,9750,11050,8782,2498,8736,143315
2020-10-17,08:30:00,108700,10724,12216,9712,3046,9540,153938
2020-10-17,09:00:00,113669,11351,14167,11397,3896,10998,165478
2020-10-17,09:30:00,120113,13789,15753,12155,4553,12030,178393
2020-10-17,10:00:00,123478,14304,15693,12540,4281,12574,182870
2020-10-17,10:30:00,123165,15135,17912,14363,4563,15159,190297
2020-10-17,11:00:00,126347,15678,18714,14402,4695,14769,194605
2020-10-17,11:30:00,126776,16831,19132,15457,5684,15914,199794
2020-10-17,12:00:00,127947,15729,18364,15130,5200,15866,198236
2020-10-17,12:30:00,129126,16685,18510,14722,5159,15833,200035
2020-10-17,13:00:00,128895,16623,19374,15666,5067,15219,200844
2020-10-17,13:30:00,131558,16909,19876,15357,5483,15699,204882
2020-10-17,14:00:00,126813,16443,18818,13857,4777,14012,194720
2020-10-17,14:30:00,126061,16058,19031,14110,5425,14313,194998
2020-10-17,15:00:00,127694,14691,17908,13862,4363,13435,191953
2020-10-17,15:30:00,127422,15238,18820,15656,4728,14790,196654
2020-10-17,16:00:00,122166,15662,19067,14240,5499,14556,191190
2020-10-17,16:30:00,122087,14393,17253,14775,4849,15447,188804
2020-10-17,17:00:00,122406,16172,19202,15394,5510,15953,194637
2020-10-17,17:30:00,121991,14145,17455,14636,4582,15159,187968
2020-10-17,18:00:00,126086,14659,19436,16619,4621,17351,198772
2020-10-17,18:30:00,128184,15806,20449,17188,6045,17505,205177
2020-10-17,19:00:00,128323,16062,19446,17251,3859,15616,200557
2020-10-17,19:30:00,131326,15883,20552,17308,6158,15570,206797
2020-10-17,20:00:00,132859,15674,18947,15787,5134,15259,203660
2020-10-17,20:30:00,132004,15051,18204,15457,5153,14393,200262
2020-10-17,21:00:00,135372,16804,18820,14826,6139,14176,206137
2020-10-17,21:30:00,129839,14691,16190,11902,5135,12150,189907
2020-10-17,22:00:00,124001,14032,14168,10138,4498,10612,177449
2020-10-17,22:30:00,123149,14160,13945,9390,4587,9543,174774
2020-10-17,23:00:00,119963,12969,13919,9171,4281,10031,170334
2020-10-17,23:30:00,119750,12808,13521,9832,4026,9862,169799
2020-10-18,00:00:00,119266,12370,13641,10151,3702,10442,169572
2020-10-18,00:30:00,119727,12972,13242,9715,2895,10153,168704
2020-10-18,01:00:00,114390,11978,12109,8878,1888,10906,160149
2020-10-18,01:30:00,113039,11363,11820,8727,2018,11070,158037
2020-10-18,02:00:00,109283,11040,10682,8215,2426,10501,152147
2020-10-18,02:30:00,106309,13288,12022,8394,2863,6627,149503
2020-10-18,03:00:00,101822,14308,11430,7439,2716,6629,144344
2020-10-18,03:30:00,103173,13729,11385,7435,2768,5680,144170
2020-10-18,04:00:00,100835,13579,12136,8294,2376,4122,141342
2020-10-18,04:30:00,99094,14160,12061,7916,2373,3751,139355
2020-10-18,05:00:00,96086,14297,11629,8765,2505,3997,137279
2020-10-18,05:30:00,93383,14770,11919,8063,2465,3742,134342
2020-10-18,06:00:00,93507,11832,8925,9157,2985,4225,130631
2020-10-18,06:30:00,97837,11594,11553,9218,2765,7787,140754
2020-10-18,07:00:00,97184,10101,11335,9287,2266,8727,138900
2020-10-18,07:30:00,98437,10031,11463,9939,2207,7540,139617
2020-10-18,08:00:00,98164,10457,11308,9224,2252,7783,139188
2020-10-18,08:30:00,101947,10461,11301,9389,2508,7747,143353
2020-10-18,09:00:00,107141,11629,12816,10691,2935,9098,154310
2020-10-18,09:30:00,111423,12611,14690,11183,3153,9561,162621
2020-10-18,10:00:00,116628,14573,16001,12145,4039,10601,173987
2020-10-18,10:30:00,121271,14545,16515,12137,5033,11992,181493
2020-10-18,11:00:00,123119,14887,16902,12789,3857,15035,186589
2020-10-18,11:30:00,126594,16526,17508,13381,4637,12664,191310
2020-10-18,12:00:00,126896,16144,19590,14859,4925,15250,197664
2020-10-18,12:30:00,129079,15699,19568,15717,4489,15968,200520
2020-10-18,13:00:00,133609,17243,20032,14816,5350,13018,204068
2020-10-18,13:30:00,131906,17096,19198,13703,4678,12981,199562
2020-10-18,14:00:00,127462,16197,18699,14190,4732,12424,193704
2020-10-18,14:30:00,125563,14671,19884,12595,4583,15542,192838
2020-10-18,15:00:00,123581,14233,16439,11834,5343,15135,186565
2020-10-18,15:30:00,123686,14042,16505,12005,5441,15724,187403
2020-10-18,16:00:00,123276,13876,17149,12546,5675,16198,188720
2020-10-18,16:30:00,119482,13903,16430,12732,5018,12242,179807
2020-10-18,17:00:00,123525,15340,18295,13351,5392,12570,188473
2020-10-18,17:30:00,124880,14720,19343,14315,5521,13906,192685
2020-10-18,18:00:00,125627,13463,18150,13985,5082,14213,190520
2020-10-18,18:30:00,127570,15238,20220,15743,6043,15454,200268
2020-10-18,19:00:00,129599,15147,19821,15134,5693,15251,200645
2020-10-18,19:30:00,133708,16852,20520,15756,5732,14663,207231
2020-10-18,20:00:00,137280,15685,18909,14617,5179,13845,205515
2020-10-18,20:30:00,144683,15384,18167,14398,5151,13460,211243
2020-10-18,21:00:00,140765,16591,18763,13260,5408,13437,208224
2020-10-18,21:30:00,133575,15710,17756,12258,5305,11887,196491
2020-10-18,22:00:00,127189,14683,16304,10449,4665,11670,184960
2020-10-18,22:30:00,123166,14386,15243,10128,4041,10210,177174
2020-10-18,23:00:00,122910,14195,15265,10035,3613,10475,176493
2020-10-18,23:30:00,121784,12996,15076,10502,3800,10512,174670
2020-10-19,00:00:00,118122,12218,14282,10189,3838,10253,168902
2020-10-19,00:30:00,118086,12091,13864,9599,3740,10813,168193
2020-10-19,01:00:00,114443,11164,12116,8991,3085,10710,160509
2020-10-19,01:30:00,114917,10699,11359,8631,1484,11358,158448
2020-10-19,02:00:00,113041,9831,10784,7685,2028,10463,153832
2020-10-19,02:30:00,109130,8149,12358,7934,3136,8863,149570
2020-10-19,03:00:00,103581,8824,13196,7525,2918,3823,139867
2020-10-19,03:30:00,99514,7925,12992,8412,2648,3885,135376
2020-10-19,04:00:00,95505,8100,13183,9086,2538,3551,131963
2020-10-19,04:30:00,93823,7870,12381,7905,2533,3495,128007
2020-10-19,05:00:00,95207,8041,11444,8355,2876,4254,130177
2020-10-19,05:30:00,96479,8609,13127,8232,2910,3732,133089
2020-10-19,06:00:00,96446,7150,12338,8869,3285,4206,132294
2020-10-19,06:30:00,105067,9915,13216,9630,3141,8343,149312
2020-10-19,07:00:00,106058,10203,12053,10219,2889,8620,150042
2020-10-19,07:30:00,110366,11455,14143,11507,3581,9990,161042
2020-10-19,08:00:00,118744,10846,14636,11881,3702,11511,171320
2020-10-19,08:30:00,127348,11397,14750,13044,3850,12646,183035
2020-10-19,09:00:00,128097,12575,16011,14241,4557,15141,190622
2020-10-19,09:30:00,132131,15182,17700,13896,5193,14689,198791
2020-10-19,10:00:00,133865,15473,17838,13170,5354,14306,200006
2020-10-19,10:30:00,134345,16643,18291,12580,5413,14165,201437
2020-10-19,11:00:00,133155,16349,18551,14115,5311,15030,202511
2020-10-19,11:30:00,140702,15916,18430,13526,4955,15454,208983
2020-10-19,12:00:00,139731,15487,18158,13583,5426,16151,208536
2020-10-19,12:30:00,137625,16556,18623,14167,5548,16500,209019
2020-10-19,13:00:00,137850,16529,20227,15499,5486,17749,213340
2020-10-19,13:30:00,130546,16905,19808,15306,5173,10900,198638
2020-10-19,14:00:00,138334,17842,20297,16193,5230,17423,215319
2020-10-19,14:30:00,132085,17588,20030,15309,6043,16961,208016
2020-10-19,15:00:00,128257,15749,17413,13252,6419,16238,197328
2020-10-19,15:30:00,127617,15591,18388,13226,6120,15162,196104
2020-10-19,16:00:00,130704,14993,19368,14713,5458,16688,201924
2020-10-19,16:30:00,133552,15446,19849,14852,5436,17062,206197
2020-10-19,17:00:00,135522,14987,20008,16188,5299,16244,208248
2020-10-19,17:30:00,136892,16280,20467,17286,6305,18008,215238
2020-10-19,18:00:00,133075,15156,21287,17117,5991,17705,210331
2020-10-19,18:30:00,141049,17402,24372,19806,7085,20098,229812
2020-10-19,19:00:00,138116,18841,23027,18614,7360,19761,225719
2020-10-19,19:30:00,136544,18208,22694,19182,6071,19153,221852
2020-10-19,20:00:00,137890,16711,20051,16228,5416,17186,213482
2020-10-19,20:30:00,132589,15506,18868,14277,5560,15303,202103
2020-10-19,21:00:00,134748,15695,18546,14577,6193,14366,204125
2020-10-19,21:30:00,125938,14843,16872,12007,4786,11542,185988
2020-10-19,22:00:00,123767,14783,15395,10290,5103,10670,180008
2020-10-19,22:30:00,122844,14599,15283,10276,4635,10125,177762
2020-10-19,23:00:00,120977,14364,14940,10366,4889,10234,175770
2020-10-19,23:30:00,118044,12677,14213,10608,3933,10904,170379
2020-10-20,00:00:00,120437,14115,14131,9818,4587,10090,173178
2020-10-20,00:30:00,118101,12827,13646,9142,4101,9881,167698
2020-10-20,01:00:00,110289,12164,13417,8815,2937,7622,155244
2020-10-20,01:30:00,107639,8202,13103,9085,3262,9222,150513
2020-10-20,02:00:00,105914,7503,12517,8877,1933,6985,143729
2020-10-20,02:30:00,104190,6804,11932,8670,3114,6352,141062
2020-10-20,03:00:00,98737,7051,11517,8277,2544,4197,132323
2020-10-20,03:30:00,94699,8231,12360,8788,2617,4133,130828
2020-10-20,04:00:00,90546,8907,12523,8142,3099,4336,127553
2020-10-20,04:30:00,91779,8302,12860,8826,2912,4830,129509
2020-10-20,05:00:00,91060,8200,12437,8639,2862,4687,127885
2020-10-20,05:30:00,88472,7978,11736,7747,3000,4135,123068
2020-10-20,06:00:00,92080,8767,12459,8180,2153,4835,128474
2020-10-20,06:30:00,105778,10635,13358,10414,2113,9224,151522
2020-10-20,07:00:00,108717,10315,12421,10569,1907,9932,153861
2020-10-20,07:30:00,113462,10775,12600,10294,2971,10781,160883
2020-10-20,08:00:00,118324,11108,14155,12005,2627,12051,170270
2020-10-20,08:30:00,126296,12813,16321,13518,4680,15321,188949
2020-10-20,09:00:00,132807,14889,19857,16882,4732,18239,207406
2020-10-20,09:30:00,132635,16012,19157,15732,4813,16384,204733
2020-10-20,10:00:00,131688,14915,17763,13746,4668,15944,198724
2020-10-20,10:30:00,129796,14860,17989,12853,4436,15395,195329
2020-10-20,11:00:00,129076,15980,18773,13811,5049,15870,198559
2020-10-20,11:30:00,127697,16657,18874,13999,4724,15720,197671
2020-10-20,12:00:00,127725,16217,18296,13524,4928,15727,196417
2020-10-20,12:30:00,133124,16607,20122,15983,5110,18231,209177
2020-10-20,13:00:00,128739,16875,19977,15350,5926,17069,203936
2020-10-20,13:30:00,131561,16902,20837,16244,4738,15892,206174
2020-10-20,14:00:00,129104,16355,19561,15723,4947,16129,201819
2020-10-20,14:30:00,128165,15893,20163,15694,5051,16494,201460
2020-10-20,15:00:00,130317,15983,20232,15914,4775,17021,204242
2020-10-20,15:30:00,132469,16074,20302,16134,4499,17548,207026
2020-10-20,16:00:00,134621,16165,20371,16354,4223,18075,209809
2020-10-20,16:30:00,124701,16256,20441,16575,3948,18602,200523
2020-10-20,17:00:00,131660,15828,19736,17243,4144,19261,207872
2020-10-20,17:30:00,131218,15417,19561,16555,3856,18350,204957
2020-10-20,18:00:00,138055,15808,21617,18379,4243,20270,218372
2020-10-20,18:30:00,136082,16561,22782,19179,4165,19848,218617
2020-10-20,19:00:00,141226,18091,21670,18923,4784,20335,225029
2020-10-20,19:30:00,136577,17662,21712,18631,5170,18792,218544
2020-10-20,20:00:00,133941,16582,18835,15475,3620,15331,203784
2020-10-20,20:30:00,135121,15716,17416,14130,3787,13928,200098
2020-10-20,21:00:00,131200,15876,17437,13957,3882,14315,196667
2020-10-20,21:30:00,127252,15530,16930,11846,4421,12384,188363
2020-10-20,22:00:00,121612,13816,15221,10329,3578,9505,174061
2020-10-20,22:30:00,120282,14086,15200,10635,3670,9863,173736
2020-10-20,23:00:00,120481,13835,13951,10098,3487,9816,171668
2020-10-20,23:30:00,116906,14224,14755,10263,3172,9567,168887
2020-10-21,00:00:00,119356,13594,14722,10293,2772,9809,170546
2020-10-21,00:30:00,116299,11659,13140,9023,3036,8699,161856
2020-10-21,01:00:00,111943,13103,14244,8024,3104,8890,159308
2020-10-21,01:30:00,107891,13000,13372,7789,1960,9010,153022
2020-10-21,02:00:00,103782,12199,12155,8027,1796,8896,146855
2020-10-21,02:30:00,102417,11152,9703,7401,551,8565,139789
2020-10-21,03:00:00,100780,10377,8398,7947,571,10754,138827
2020-10-21,03:30:00,98796,8774,6708,8502,469,11556,134805
2020-10-21,04:00:00,93155,9199,6170,7845,432,10212,127013
2020-10-21,04:30:00,93097,10626,8158,8426,1970,4768,127045
2020-10-21,05:00:00,93387,11102,8975,9564,1808,5021,129857
2020-10-21,05:30:00,93205,11102,8936,9498,2102,4496,129339
2020-10-21,06:00:00,93967,11606,8954,9581,2082,5253,131443
2020-10-21,06:30:00,103948,11196,12583,10370,1776,8733,148606
2020-10-21,07:00:00,106827,9857,13169,10143,1506,9252,150754
2020-10-21,07:30:00,109506,11224,13077,10989,2002,11077,157875
2020-10-21,08:00:00,121778,11045,15052,12555,2209,12453,175092
2020-10-21,08:30:00,127675,13076,17014,13895,3226,14716,189602
2020-10-21,09:00:00,133606,15272,18245,14129,4077,16337,201666
2020-10-21,09:30:00,133230,15743,18356,14073,4496,15737,201635
2020-10-21,10:00:00,134554,16005,18982,13710,4079,15941,203271
2020-10-21,10:30:00,136025,16650,18409,13686,4435,14315,203520
2020-10-21,11:00:00,137496,16100,17954,13855,4732,15888,206025
2020-10-21,11:30:00,135327,15827,18546,13853,4572,15579,203704
2020-10-21,12:00:00,129357,16668,19053,13310,4558,14379,197325
2020-10-21,12:30:00,129263,15774,18620,12420,4374,14529,194980
2020-10-21,13:00:00,127703,16882,20077,14892,4489,15198,199241
2020-10-21,13:30:00,127873,16611,19589,14921,4878,15591,199463
2020-10-21,14:00:00,129437,16995,19450,13536,4412,15053,198883
2020-10-21,14:30:00,128404,16306,19824,14539,3983,16589,199645
2020-10-21,15:00:00,125027,15616,17631,12864,4114,14545,189797
2020-10-21,15:30:00,123563,15351,18193,12783,4706,13960,188556
2020-10-21,16:00:00,126362,15932,18751,14178,4417,14358,193998
2020-10-21,16:30:00,124954,15379,19091,15362,3548,15254,193588
2020-10-21,17:00:00,124732,15092,19018,14876,4203,16241,194162
2020-10-21,17:30:00,124530,15745,19907,15766,4684,16383,197015
2020-10-21,18:00:00,126375,16785,22317,18397,4732,18895,207501
2020-10-21,18:30:00,131024,17278,22775,20048,4104,20470,215699
2020-10-21,19:00:00,134843,17809,23413,21030,4836,21386,223317
2020-10-21,19:30:00,130764,16703,21072,18767,5019,20266,212591
2020-10-21,20:00:00,130552,16183,20373,16633,4505,16496,204742
2020-10-21,20:30:00,130923,15477,18992,15333,3995,15671,200391
2020-10-21,21:00:00,130439,16678,18247,14333,4732,14563,198992
2020-10-21,21:30:00,127089,15122,16176,11631,4795,11260,186073
2020-10-21,22:00:00,119583,13882,15249,10543,4435,9315,173007
2020-10-21,22:30:00,120939,13317,13906,9456,3984,9637,171239
2020-10-21,23:00:00,119142,13014,14073,9677,3270,9454,168630
2020-10-21,23:30:00,116232,13569,14064,9594,3367,9752,166578
2020-10-22,00:00:00,115335,13133,12994,9117,3747,9098,163424
2020-10-22,00:30:00,110542,12200,13152,9227,2855,9517,157493
2020-10-22,01:00:00,109851,11841,11547,8368,2774,8942,153323
2020-10-22,01:30:00,107060,12401,12936,8729,2829,8824,152779
2020-10-22,02:00:00,104978,11628,11455,8023,2724,7501,146309
2020-10-22,02:30:00,104304,13578,11646,7677,2879,6628,146712
2020-10-22,03:00:00,99020,14966,12727,7786,4108,3448,142055
2020-10-22,03:30:00,97956,14284,12317,7652,3885,3363,139457
2020-10-22,04:00:00,96296,9550,13394,7626,3626,3271,133763
2020-10-22,04:30:00,93002,7678,11472,6939,1525,3082,123698
2020-10-22,05:00:00,90697,7957,11759,6835,1551,2990,121789
2020-10-22,05:30:00,93086,7616,11422,7375,1373,3362,124234
2020-10-22,06:00:00,94636,7568,11569,7538,1506,3263,126080
2020-10-22,06:30:00,102606,9591,11391,8980,1213,8209,141990
2020-10-22,07:00:00,104215,9496,10642,9631,1459,8934,144377
2020-10-22,07:30:00,105371,9375,11287,10622,1421,10818,148894
2020-10-22,08:00:00,114794,10995,12845,11624,1699,12833,164790
2020-10-22,08:30:00,124372,12527,14803,13340,2478,14236,181756
2020-10-22,09:00:00,127327,14046,18199,15455,3807,17287,196121
2020-10-22,09:30:00,127940,15191,19113,15950,4231,17470,199895
2020-10-22,10:00:00,127968,15578,18578,14685,4205,16065,197079
2020-10-22,10:30:00,127997,15966,18043,13420,4179,14661,194266
2020-10-22,11:00:00,130483,16182,17928,12920,4533,14891,196937
2020-10-22,11:30:00,129838,16308,19390,13738,4437,16041,199752
2020-10-22,12:00:00,128564,17278,19915,13766,4647,15384,199554
2020-10-22,12:30:00,130945,16379,20017,14889,4344,17299,203873
2020-10-22,13:00:00,132139,16765,20908,16378,4395,18018,208603
2020-10-22,13:30:00,131715,17823,20103,15527,4129,16550,205847
2020-10-22,14:00:00,130021,16848,20670,15990,4440,16825,204794
2020-10-22,14:30:00,130849,16088,19168,15611,4971,17630,204317
2020-10-22,15:00:00,128934,16014,18303,14407,4378,16037,198073
2020-10-22,15:30:00,128608,16196,18749,14935,4905,17064,200457
2020-10-22,16:00:00,126800,15604,18243,14232,4360,16659,195898
2020-10-22,16:30:00,126148,15450,19072,14765,4122,16591,196148
2020-10-22,17:00:00,129362,15857,19160,15067,4309,17115,200870
2020-10-22,17:30:00,125106,17236,20786,16410,4693,17957,202188
2020-10-22,18:00:00,131180,17204,21993,18465,4223,18481,211546
2020-10-22,18:30:00,134546,18373,22957,18709,4679,19461,218725
2020-10-22,19:00:00,131144,17760,22260,18143,5018,19144,213469
2020-10-22,19:30:00,131462,16944,20826,16919,4657,18890,209698
2020-10-22,20:00:00,133537,17643,21833,17867,5039,17385,213304
2020-10-22,20:30:00,132418,16011,20444,16916,4343,15907,206039
2020-10-22,21:00:00,132762,17183,19238,14951,4457,15618,204209
2020-10-22,21:30:00,127382,15052,16130,11686,4168,11604,186022
2020-10-22,22:00:00,120511,14432,14990,9824,4736,10137,174630
2020-10-22,22:30:00,118243,14092,14938,9850,4141,10090,171354
2020-10-22,23:00:00,117977,13496,15072,9811,3705,10856,170917
2020-10-22,23:30:00,118232,13500,14126,9829,3311,10644,169642
2020-10-23,00:00:00,115816,13243,13464,8751,3310,9659,164243
2020-10-23,00:30:00,113400,12986,12802,7674,3310,8674,158846
2020-10-23,01:00:00,110295,11888,12203,7266,3416,8467,153535
2020-10-23,01:30:00,107967,10659,11672,8004,2808,9692,150802
2020-10-23,02:00:00,105337,10601,10554,7943,1933,11418,147786
2020-10-23,02:30:00,100960,11243,10786,7794,434,12631,143848
2020-10-23,03:00:00,100037,11139,10565,7502,389,12232,141864
2020-10-23,03:30:00,98178,11192,9981,7211,252,9909,136723
2020-10-23,04:00:00,95280,11909,10913,7662,828,9931,136523
2020-10-23,04:30:00,93806,14289,12474,7671,1852,4742,134834
2020-10-23,05:00:00,92785,10514,12061,7488,1543,4917,129308
2020-10-23,05:30:00,92692,10474,11966,7771,1618,5085,129606
2020-10-23,06:00:00,97440,12922,11964,8693,1707,6936,139662
2020-10-23,06:30:00,102189,11582,11962,9616,1796,8788,145933
2020-10-23,07:00:00,101816,9770,12229,9643,1384,9241,144083
2020-10-23,07:30:00,107238,10483,13063,10758,2131,10544,154217
2020-10-23,08:00:00,112116,11167,13646,10200,2892,10631,160652
2020-10-23,08:30:00,121204,12819,16881,13149,3445,13380,180878
2020-10-23,09:00:00,123414,13455,17316,15056,4060,16580,189881
2020-10-23,09:30:00,127593,14835,18199,14521,4976,16644,196768
2020-10-23,10:00:00,125809,16012,19434,14657,4874,15543,196329
2020-10-23,10:30:00,124310,16414,18720,13456,5156,14053,192109
2020-10-23,11:00:00,123800,14607,17543,12754,4701,13734,187139
2020-10-23,11:30:00,126032,14906,18362,14800,4541,15328,193969
2020-10-23,12:00:00,124946,15954,19197,14877,4998,16160,196132
2020-10-23,12:30:00,125941,16499,20862,15778,4570,17637,201287
2020-10-23,13:00:00,125000,17370,20644,15627,5347,17021,201009
2020-10-23,13:30:00,125395,17949,20824,15449,4853,16823,201293
2020-10-23,14:00:00,125910,17980,19864,14683,4627,16921,199985
2020-10-23,14:30:00,123490,15975,18311,13852,5086,15494,192208
2020-10-23,15:00:00,122461,15614,18657,14340,4368,15498,190938
2020-10-23,15:30:00,122724,16413,19917,15186,4644,16149,195033
2020-10-23,16:00:00,124162,15973,19478,15199,4171,16011,194994
2020-10-23,16:30:00,117972,15842,19839,16147,4522,17357,191679
2020-10-23,17:00:00,121325,16336,20877,16633,5069,17766,198006
2020-10-23,17:30:00,123951,18018,21869,17608,5375,17772,204593
2020-10-23,18:00:00,123323,16371,21757,17355,5005,19860,203671
2020-10-23,18:30:00,128281,16936,21621,18138,4622,19378,208976
2020-10-23,19:00:00,128146,16708,21628,18605,4829,19699,209615
2020-10-23,19:30:00,126227,16331,20240,17967,4517,18756,204038
2020-10-23,20:00:00,126973,15827,19764,16607,3966,16750,199887
2020-10-23,20:30:00,127834,16208,19744,15954,4721,16628,201089
2020-10-23,21:00:00,125768,14594,18536,14793,5618,15942,195251
2020-10-23,21:30:00,125024,14835,16788,12024,5661,12190,186522
2020-10-23,22:00:00,120278,13698,14532,10000,5133,10472,174113
2020-10-23,22:30:00,116788,12907,12696,9427,4372,10085,166275
2020-10-23,23:00:00,119592,13458,13535,9452,4650,10417,171104
2020-10-23,23:30:00,117244,12291,13058,9355,3935,9853,165736
2020-10-24,00:00:00,117106,12924,13858,9340,3925,9744,166897
2020-10-24,00:30:00,114219,12531,12366,8460,3251,9864,160691
2020-10-24,01:00:00,110152,10475,10788,7533,2276,10067,151291
2020-10-24,01:30:00,109942,10981,12483,6999,2126,9848,152379
2020-10-24,02:00:00,105179,12114,12760,8127,1793,10029,150002
2020-10-24,02:30:00,105131,12398,11886,7479,1443,9991,148328
2020-10-24,03:00:00,99437,13256,12091,7563,1995,7413,141755
2020-10-24,03:30:00,96890,13100,12033,8568,1837,3743,136171
2020-10-24,04:00:00,87174,13460,11381,8198,1899,3779,125891
2020-10-24,04:30:00,92593,13350,11804,9252,1795,3922,132716
2020-10-24,05:00:00,91369,10821,7844,9423,2072,3943,125472
2020-10-24,05:30:00,85007,10873,7769,9029,2261,4236,119175
2020-10-24,06:00:00,93218,9895,7962,9352,2174,4491,127092
2020-10-24,06:30:00,94192,10347,10788,9038,2128,8014,134507
2020-10-24,07:00:00,94991,8919,9243,7466,1802,7308,129729
2020-10-24,07:30:00,95824,9834,9954,7854,2337,7903,133706
2020-10-24,08:00:00,97850,10416,11229,8743,2332,9482,140052
2020-10-24,08:30:00,105503,10821,12439,9738,2565,9696,150762
2020-10-24,09:00:00,110012,11476,12578,10776,3400,10399,158641
2020-10-24,09:30:00,112261,11765,12904,10723,3524,10721,161898
2020-10-24,10:00:00,114705,12002,14980,11966,3914,10677,168244
2020-10-24,10:30:00,115697,13105,16062,13071,4478,12556,174969
2020-10-24,11:00:00,118831,14225,17053,13480,4320,12434,180343
2020-10-24,11:30:00,119426,14331,17475,14242,4687,14297,184458
2020-10-24,12:00:00,120082,15524,17920,14272,5330,14377,187505
2020-10-24,12:30:00,121749,14061,16996,14620,4301,13873,185600
2020-10-24,13:00:00,125000,14956,17889,14742,4471,14347,191405
2020-10-24,13:30:00,121997,14832,19552,15623,4920,15226,192150
2020-10-24,14:00:00,119799,15408,18679,14027,5248,13932,187093
2020-10-24,14:30:00,119909,16023,18140,13607,5806,13238,186723
2020-10-24,15:00:00,119929,15074,17823,13675,4657,13874,185032
2020-10-24,15:30:00,118288,15555,19125,14695,4797,14264,186724
2020-10-24,16:00:00,114640,15070,17254,12812,5328,13684,178788
2020-10-24,16:30:00,116462,15673,18363,14251,4918,14684,184351
2020-10-24,17:00:00,120477,15021,18416,14612,4927,14675,188128
2020-10-24,17:30:00,118835,19012,21723,17451,5900,16787,199708
2020-10-24,18:00:00,119793,17733,21371,15034,5251,16897,196079
2020-10-24,18:30:00,129934,15316,19180,15475,5674,18068,203647
2020-10-24,19:00:00,127748,16214,19477,15343,5242,17293,201317
2020-10-24,19:30:00,130825,16813,18911,14749,5170,17327,203795
2020-10-24,20:00:00,129860,16467,22353,15131,5222,17162,206195
2020-10-24,20:30:00,133102,15857,21823,15036,5113,17699,208630
2020-10-24,21:00:00,132251,19133,21536,14981,5290,17598,210789
2020-10-24,21:30:00,129157,15144,16988,11467,5876,12112,190744
2020-10-24,22:00:00,122299,14123,15843,10430,4936,10365,177996
2020-10-24,22:30:00,121326,13890,14533,10011,4661,10267,174688
2020-10-24,23:00:00,118642,13036,14723,10042,4777,9135,170355
2020-10-24,23:30:00,114394,12509,13785,9236,4262,8733,162919
2020-10-25,00:00:00,111191,12632,14528,9608,4833,9243,162035
2020-10-25,00:30:00,110463,11357,12502,8427,4007,9304,156060
2020-10-25,01:00:00,108202,10347,10907,7697,1814,9756,148723
2020-10-25,01:30:00,104970,12659,12639,7951,1588,9253,149060
2020-10-25,02:00:00,102869,13180,11726,8488,1756,8860,146879
2020-10-25,02:30:00,99108,13142,11090,7209,1398,7534,139481
2020-10-25,03:00:00,102669,13217,10199,8127,1141,9925,145278
2020-10-25,03:30:00,90391,4811,3264,7506,1045,3104,110121
2020-10-25,04:00:00,97881,12371,7257,8184,2405,3347,131445
2020-10-25,04:30:00,95232,11802,7265,7742,2870,3691,128602
2020-10-25,05:00:00,92293,11181,7374,7918,2585,3228,124579
2020-10-25,05:30:00,95701,11188,11572,8558,2175,7178,136372
2020-10-25,06:00:00,92855,9276,10094,7663,2172,6255,128315
2020-10-25,06:30:00,91506,9430,10381,7307,2180,6684,127488
2020-10-25,07:00:00,95026,9598,10239,7668,2062,6491,131084
2020-10-25,07:30:00,95959,9440,10812,8545,2730,6675,134161
2020-10-25,08:00:00,98762,10611,11760,8748,2806,7372,140059
2020-10-25,08:30:00,104443,10859,12049,9021,2855,7429,146656
2020-10-25,09:00:00,107668,11764,12812,9839,3467,8812,154362
2020-10-25,09:30:00,110810,13287,13955,9852,3813,9721,161438
2020-10-25,10:00:00,113450,12757,14011,10462,3750,9392,163822
2020-10-25,10:30:00,117475,14097,15143,12682,4127,13543,177067
2020-10-25,11:00:00,118710,14374,17355,11714,4062,10950,177165
2020-10-25,11:30:00,119656,14826,16832,13014,4458,12538,181324
2020-10-25,12:00:00,125134,15205,17017,13639,4874,12520,188389
2020-10-25,12:30:00,124328,15657,18312,13356,4827,12262,188742
2020-10-25,13:00:00,121687,15566,17438,13236,4501,12452,184880
2020-10-25,13:30:00,122752,14493,16593,13324,3917,15133,186212
2020-10-25,14:00:00,120672,16104,18810,10810,3957,14884,185237
2020-10-25,14:30:00,117860,15975,15810,11841,3985,11093,176564
2020-10-25,15:00:00,118631,15350,17782,11042,4773,14543,182121
2020-10-25,15:30:00,117375,13670,15909,12261,4218,11599,175032
2020-10-25,16:00:00,117960,13077,15753,12428,4792,11491,175501
2020-10-25,16:30:00,123095,13785,17582,13258,4954,12672,185346
2020-10-25,17:00:00,122737,14004,16913,12857,4350,12539,183400
2020-10-25,17:30:00,125530,14094,17767,13706,5104,16807,193008
2020-10-25,18:00:00,125095,14601,21023,12881,5661,17916,197177
2020-10-25,18:30:00,124738,14255,21185,17582,5099,18476,201335
2020-10-25,19:00:00,127939,16945,20914,17451,4376,18388,206013
2020-10-25,19:30:00,126618,16813,20100,13452,4951,17579,199513
2020-10-25,20:00:00,133160,16467,16966,15853,5803,15933,204182
2020-10-25,20:30:00,125588,15857,15490,11724,5154,11242,185055
2020-10-25,21:00:00,130840,14579,16260,12957,4958,11747,191341
2020-10-25,21:30:00,123283,15144,15682,11141,4781,10390,180421
2020-10-25,22:00:00,121890,12810,13502,10034,4068,9979,172283
2020-10-25,22:30:00,120455,13132,13444,9426,3899,9841,170197
2020-10-25,23:00:00,118348,12881,13952,9657,3695,10438,168971
2020-10-25,23:30:00,116104,12359,13544,9233,3374,10956,165570
2020-10-26,00:00:00,113145,12107,11993,9218,4101,10295,160859
2020-10-26,00:30:00,112919,10984,11682,7510,1981,9761,154837
2020-10-26,01:00:00,112734,10453,12284,7916,1861,10585,155833
2020-10-26,01:30:00,109375,8201,12859,7214,1912,10315,149876
2020-10-26,02:00:00,105352,7432,13183,8309,1888,10086,146250
2020-10-26,02:30:00,104370,7935,13297,8100,2152,8974,144828
2020-10-26,03:00:00,103388,8439,13412,7891,2416,7862,143408
2020-10-26,03:30:00,101504,8788,13745,7960,2756,3888,138641
2020-10-26,04:00:00,97524,8413,12584,7439,1677,3628,131265
2020-10-26,04:30:00,94916,8914,13703,8601,1668,3628,131430
2020-10-26,05:00:00,94429,10028,14017,7807,2522,3822,132625
2020-10-26,05:30:00,97107,10302,13445,9509,2636,8237,141236
2020-10-26,06:00:00,97084,9249,10851,9263,2314,7780,136541
2020-10-26,06:30:00,100179,9383,11185,8630,2268,7620,139265
2020-10-26,07:00:00,105465,9703,12067,9942,2072,9217,148466
2020-10-26,07:30:00,112170,10783,12553,10067,2838,10155,158566
2020-10-26,08:00:00,120159,11195,13377,11481,2664,11533,170409
2020-10-26,08:30:00,124394,12645,14842,12428,3955,14273,182537
2020-10-26,09:00:00,125721,14756,17309,14200,4576,15077,191639
2020-10-26,09:30:00,128307,15754,18126,14428,4473,16003,197091
2020-10-26,10:00:00,127201,15146,16214,12311,4327,14959,190158
2020-10-26,10:30:00,127719,15727,16511,12097,5505,13732,191291
2020-10-26,11:00:00,126113,14980,17281,12118,4732,13234,188458
2020-10-26,11:30:00,124390,15424,17601,13659,4952,13534,189560
2020-10-26,12:00:00,129027,15977,17026,13597,5330,12892,193849
2020-10-26,12:30:00,126569,14997,17873,12960,5215,15080,192694
2020-10-26,13:00:00,127007,14413,16724,12513,4949,14110,189716
2020-10-26,13:30:00,127202,14451,16559,12358,4818,14088,189476
2020-10-26,14:00:00,128698,16058,17975,12697,5281,15032,195741
2020-10-26,14:30:00,131332,16251,17209,12317,5204,14447,196760
2020-10-26,15:00:00,125982,15228,16696,13163,4704,14465,190238
2020-10-26,15:30:00,127445,14870,16068,12324,4556,14140,189403
2020-10-26,16:00:00,128033,14510,16509,12737,4768,14155,190712
2020-10-26,16:30:00,127507,14278,16893,12700,5088,14347,190813
2020-10-26,17:00:00,128448,15680,17750,13253,5371,14434,194936
2020-10-26,17:30:00,131248,15492,18645,14373,4679,16945,201382
2020-10-26,18:00:00,132857,17360,20425,16655,5521,18211,211029
2020-10-26,18:30:00,135401,18372,22396,18214,5640,19708,219731
2020-10-26,19:00:00,137474,18237,22223,17627,5652,18703,219916
2020-10-26,19:30:00,136828,17213,20900,16289,5374,16059,212663
2020-10-26,20:00:00,134295,15894,19627,16142,5325,16069,207352
2020-10-26,20:30:00,132389,15051,17866,13071,5104,13603,197084
2020-10-26,21:00:00,129176,14970,15380,11561,4679,12388,188154
2020-10-26,21:30:00,125244,14794,15486,11266,5297,12071,184158
2020-10-26,22:00:00,121350,13329,13697,10049,4976,10446,173847
2020-10-26,22:30:00,119118,13701,14006,9516,5095,10334,171770
2020-10-26,23:00:00,118934,13187,13003,9552,5150,9419,169245
2020-10-26,23:30:00,115155,12782,13164,9684,4358,9675,164818
2020-10-27,00:00:00,111886,12583,13686,9589,3616,10058,161418
2020-10-27,00:30:00,113063,10144,13941,8436,2445,10028,158057
2020-10-27,01:00:00,108560,10924,11691,7854,2045,10121,151195
2020-10-27,01:30:00,103952,11918,11749,6580,1831,9788,145818
2020-10-27,02:00:00,101146,12728,12810,6955,2490,9042,145171
2020-10-27,02:30:00,101997,13889,13523,7134,2592,3442,142577
2020-10-27,03:00:00,99479,12612,13133,7341,2028,3382,137975
2020-10-27,03:30:00,93346,12656,13189,7569,2008,3298,132066
2020-10-27,04:00:00,92685,13282,13563,7598,2550,3445,133123
2020-10-27,04:30:00,90335,8294,13129,7654,1261,3897,124570
2020-10-27,05:00:00,91953,9002,13759,7329,1821,3712,127576
2020-10-27,05:30:00,98482,9163,12566,7966,1456,4427,134060
2020-10-27,06:00:00,98221,8598,10361,8296,1899,4776,132151
2020-10-27,06:30:00,101197,11454,11164,9087,2172,8090,143164
2020-10-27,07:00:00,106762,10297,11350,9009,2119,8472,148009
2020-10-27,07:30:00,110352,10732,11402,9185,2368,9619,153658
2020-10-27,08:00:00,119204,11255,14168,11945,2778,12317,171667
2020-10-27,08:30:00,127927,13494,15276,13418,3617,13744,187476
2020-10-27,09:00:00,131495,14605,17808,14783,4365,15626,198682
2020-10-27,09:30:00,128492,14946,17371,14348,4431,14545,194133
2020-10-27,10:00:00,129641,14506,17019,13381,4264,14533,193344
2020-10-27,10:30:00,123249,14258,16515,12806,3486,13371,183685
2020-10-27,11:00:00,125905,15129,16422,12370,4310,13520,187656
2020-10-27,11:30:00,124458,15163,17033,12571,4250,13023,186498
2020-10-27,12:00:00,124772,15584,19451,12790,4807,13791,191195
2020-10-27,12:30:00,131663,16069,17521,13144,5004,14425,197826
2020-10-27,13:00:00,134233,16993,18407,13780,4806,15871,204090
2020-10-27,13:30:00,128004,15776,17733,14002,4096,16058,195669
2020-10-27,14:00:00,129637,16404,17884,13533,4142,14315,195915
2020-10-27,14:30:00,127115,15722,17879,14185,4535,15319,194755
2020-10-27,15:00:00,124230,14774,18872,12781,4879,14124,189660
2020-10-27,15:30:00,123086,14140,17007,12917,4420,14393,185963
2020-10-27,16:00:00,125598,14197,17590,13694,4759,15013,190851
2020-10-27,16:30:00,126000,15835,18676,13789,4690,15028,194018
2020-10-27,17:00:00,125119,15845,18961,14331,4534,14832,193622
2020-10-27,17:30:00,126599,15627,18930,14999,4612,15798,196565
2020-10-27,18:00:00,130135,15763,20943,16939,4917,17642,206339
2020-10-27,18:30:00,131550,17058,22354,17961,5385,18896,213204
2020-10-27,19:00:00,131859,17021,21835,17914,5718,18116,212463
2020-10-27,19:30:00,131803,16942,19726,15673,5576,16189,205909
2020-10-27,20:00:00,131289,15796,17760,14325,4993,14917,199080
2020-10-27,20:30:00,134045,16204,18948,14864,5915,14465,204441
2020-10-27,21:00:00,133796,15063,16683,13760,5865,11823,196990
2020-10-27,21:30:00,127645,13386,15076,10852,5010,10956,182925
2020-10-27,22:00:00,122431,13723,14437,10282,4382,10121,175376
2020-10-27,22:30:00,120382,13580,13422,9777,4488,9271,170920
2020-10-27,23:00:00,117334,13071,12912,9743,4464,9624,167148
2020-10-27,23:30:00,115775,13144,14204,9341,4518,9476,166458
2020-10-28,00:00:00,114216,13218,14056,8940,4572,9328,164330
2020-10-28,00:30:00,113298,11708,13941,8150,3866,9224,160187
2020-10-28,01:00:00,107024,13834,13279,7284,4886,6909,153216
2020-10-28,01:30:00,104518,15468,15817,8136,5352,8659,157950
2020-10-28,02:00:00,102725,16217,14300,7083,3267,7598,151190
2020-10-28,02:30:00,103261,14909,13013,7001,2746,3955,144885
2020-10-28,03:00:00,97258,14929,12644,7287,2746,4251,139115
2020-10-28,03:30:00,89192,14586,11732,6918,2959,3893,129280
2020-10-28,04:00:00,85301,12977,8346,8103,3318,3969,122014
2020-10-28,04:30:00,85138,11296,11543,7817,2859,4064,122717
2020-10-28,05:00:00,84467,3292,7163,7313,2593,3692,108520
2020-10-28,05:30:00,85134,10791,6933,7957,2035,4030,116880
2020-10-28,06:00:00,86715,10176,7408,8279,1897,3861,118336
2020-10-28,06:30:00,96769,11454,10305,8790,2160,7866,137344
2020-10-28,07:00:00,103619,9844,11011,8736,2888,7773,143871
2020-10-28,07:30:00,107471,10380,11496,9346,2886,8833,150412
2020-10-28,08:00:00,114055,10124,12042,10559,2569,9981,159330
2020-10-28,08:30:00,121844,11637,14020,11698,3351,13243,175793
2020-10-28,09:00:00,128627,13301,16507,12807,4489,15023,190754
2020-10-28,09:30:00,129468,15583,16885,13433,5032,15717,196118
2020-10-28,10:00:00,129241,14968,15836,11598,4655,13099,189397
2020-10-28,10:30:00,127759,15024,17158,12468,4989,13935,191333
2020-10-28,11:00:00,126224,15437,16935,12263,5015,13955,189829
2020-10-28,11:30:00,126382,15464,18462,11684,4765,13576,190333
2020-10-28,12:00:00,128110,16880,18862,13112,4962,13512,195438
2020-10-28,12:30:00,131659,16080,19095,14347,5022,14686,200889
2020-10-28,13:00:00,129682,16758,18882,13963,5056,14811,199152
2020-10-28,13:30:00,130486,17099,19447,13984,5825,14316,201157
2020-10-28,14:00:00,128852,16713,18600,14909,4900,14483,198457
2020-10-28,14:30:00,126090,16077,18340,13677,5055,14509,193748
2020-10-28,15:00:00,127642,16669,18766,13909,4945,14759,196690
2020-10-28,15:30:00,127756,15450,17717,12701,5041,14063,192728
2020-10-28,16:00:00,127948,15716,18024,13832,4809,15011,195340
2020-10-28,16:30:00,128141,15982,18331,14964,4578,15960,197956
2020-10-28,17:00:00,128916,15506,18584,15389,4959,15485,198839
2020-10-28,17:30:00,128229,16122,20164,17292,5914,16948,204669
2020-10-28,18:00:00,131456,17048,21294,18087,5459,19256,212600
2020-10-28,18:30:00,129887,16703,20889,17728,5723,17885,208815
2020-10-28,19:00:00,130807,17645,21036,17824,5796,18614,211722
2020-10-28,19:30:00,133731,16535,21776,17227,6025,18757,214051
2020-10-28,20:00:00,129895,15289,19697,15896,5745,15928,202450
2020-10-28,20:30:00,128050,14889,16808,12451,5592,12980,190770
2020-10-28,21:00:00,130278,15732,16846,12692,5823,11876,193247
2020-10-28,21:30:00,127767,15629,15432,11643,5741,11094,187306
2020-10-28,22:00:00,121990,13346,14293,10307,4921,10218,175075
2020-10-28,22:30:00,121384,13351,13841,9713,4818,9983,173090
2020-10-28,23:00:00,118736,13165,13425,9704,5100,9189,169319
2020-10-28,23:30:00,117312,12315,14204,9503,4358,9625,167317
2020-10-29,00:00:00,116280,12738,13853,9971,4932,9167,166941
2020-10-29,00:30:00,112997,12028,13988,8068,4785,10005,161871
2020-10-29,01:00:00,106260,13422,12263,7503,3625,8952,152025
2020-10-29,01:30:00,105554,13688,12723,6793,3643,9740,152141
2020-10-29,02:00:00,103397,12674,11608,6666,3587,8183,146115
2020-10-29,02:30:00,100974,13767,12752,7209,2876,7513,145091
2020-10-29,03:00:00,96750,13542,12864,7095,3514,4045,137810
2020-10-29,03:30:00,96040,14120,12586,6757,3260,3763,136526
2020-10-29,04:00:00,92250,14046,12358,6631,3208,3668,132161
2020-10-29,04:30:00,89530,13725,11352,7283,2786,3911,128587
2020-10-29,05:00:00,89257,12494,8840,7090,2232,3601,123514
2020-10-29,05:30:00,88429,10529,7008,7020,2348,3783,119117
2020-10-29,06:00:00,94564,11363,7324,7450,2397,4086,127184
2020-10-29,06:30:00,102303,11506,11477,8702,2671,7980,144639
2020-10-29,07:00:00,104100,10389,9878,7610,1970,7412,141359
2020-10-29,07:30:00,111060,10538,11739,9548,3063,9109,155057
2020-10-29,08:00:00,119554,12018,13236,11107,3612,10956,170483
2020-10-29,08:30:00,124838,13364,14363,12342,4452,13898,183257
2020-10-29,09:00:00,130315,14575,17025,13659,5657,15012,196243
2020-10-29,09:30:00,131075,16200,17647,14387,5213,14414,198936
2020-10-29,10:00:00,130405,15133,17137,13670,4569,14146,195060
2020-10-29,10:30:00,128435,16967,18713,13100,4865,14302,196382
2020-10-29,11:00:00,128255,15657,18127,13822,4860,13672,194393
2020-10-29,11:30:00,126718,16192,19168,15811,5370,14070,197329
2020-10-29,12:00:00,127364,16402,19189,14555,5748,14947,198205
2020-10-29,12:30:00,128834,16499,20935,15493,5618,14767,202146
2020-10-29,13:00:00,128141,17188,21247,16912,5570,14909,203967
2020-10-29,13:30:00,125859,15380,20805,14337,5135,17711,199227
2020-10-29,14:00:00,127042,16094,19930,15899,5441,16610,201016
2020-10-29,14:30:00,127337,15518,18297,14527,5467,16159,197305
2020-10-29,15:00:00,126995,15876,18805,15025,5470,13785,195956
2020-10-29,15:30:00,126654,16234,19314,15524,5474,14167,197367
2020-10-29,16:00:00,122748,15506,18592,14789,5135,15472,192242
2020-10-29,16:30:00,123337,14821,18280,14889,5299,15793,192419
2020-10-29,17:00:00,125500,14907,17884,15011,5401,16017,194720
2020-10-29,17:30:00,123105,15502,20389,16553,5401,16782,197732
2020-10-29,18:00:00,128979,16477,21400,18426,5986,18375,209643
2020-10-29,18:30:00,129218,17056,23364,20196,6762,17100,213696
2020-10-29,19:00:00,126212,16584,21671,18120,5669,18739,206995
2020-10-29,19:30:00,127817,16987,21103,17406,6178,17222,206713
2020-10-29,20:00:00,128334,17461,21186,15980,5722,15084,203767
2020-10-29,20:30:00,127609,16825,20163,12708,6019,14491,197815
2020-10-29,21:00:00,132901,16384,17003,12455,5147,11823,195713
2020-10-29,21:30:00,132069,15881,19178,11635,5357,11420,195540
2020-10-29,22:00:00,131448,15068,16318,10652,4850,10960,189296
2020-10-29,22:30:00,123808,13629,15454,10955,4473,10412,178731
2020-10-29,23:00:00,123944,14043,15776,10935,4703,9876,179277
2020-10-29,23:30:00,116875,13099,14402,10176,4360,8774,167686
2020-10-30,00:00:00,114967,12284,14107,9367,4174,8760,163659
2020-10-30,00:30:00,116186,11920,14958,8540,4336,10140,166080
2020-10-30,01:00:00,110217,11330,14359,7212,4597,8397,156112
2020-10-30,01:30:00,106213,11159,13806,6985,3960,9404,151527
2020-10-30,02:00:00,104670,15457,16139,7760,4124,7598,155748
2020-10-30,02:30:00,100034,14369,14791,7667,2876,4300,144037
2020-10-30,03:00:00,96973,13994,14104,7454,3886,4171,140582
2020-10-30,03:30:00,96950,13546,14280,7360,3520,3870,139526
2020-10-30,04:00:00,95551,13144,13936,7309,3791,3647,137378
2020-10-30,04:30:00,94835,12450,12534,7493,3987,3905,135204
2020-10-30,05:00:00,91637,9715,8495,7487,2110,3909,123353
2020-10-30,05:30:00,91808,10568,8895,7604,2111,3764,124750
2020-10-30,06:00:00,93176,10613,9172,7517,2395,4107,126980
2020-10-30,06:30:00,99914,11126,13516,9186,2462,7367,143571
2020-10-30,07:00:00,100943,11152,13847,9550,2483,7523,145498
2020-10-30,07:30:00,103404,10421,12962,9648,3944,8032,148411
2020-10-30,08:00:00,110988,11583,13718,10117,3838,8911,159155
2020-10-30,08:30:00,115280,12044,14672,11820,4247,10920,168983
2020-10-30,09:00:00,121354,13674,16818,13107,4789,13029,182771
2020-10-30,09:30:00,123502,13922,16198,12195,5207,12548,183572
2020-10-30,10:00:00,120321,13035,16476,12826,4565,12813,180036
2020-10-30,10:30:00,122109,14492,17379,13180,5158,13286,185604
2020-10-30,11:00:00,124069,14595,18458,14038,5246,14084,190490
2020-10-30,11:30:00,129979,15451,19079,14534,5488,14096,198627
2020-10-30,12:00:00,129705,15558,19417,15064,5862,14086,199692
2020-10-30,12:30:00,130105,15533,19123,13809,6028,13544,198142
2020-10-30,13:00:00,130163,16839,18682,13795,6307,15284,201070
2020-10-30,13:30:00,129123,16334,18849,14156,5972,14190,198624
2020-10-30,14:00:00,130952,16284,18442,13792,5812,13790,199072
2020-10-30,14:30:00,130555,16339,18338,13770,5651,13856,198509
2020-10-30,15:00:00,130172,16239,19118,14012,5887,13711,199139
2020-10-30,15:30:00,129679,17244,20110,14130,6220,14099,201482
2020-10-30,16:00:00,130721,16234,19736,15017,5881,14936,202525
2020-10-30,16:30:00,129963,15828,20193,16252,5439,15120,202795
2020-10-30,17:00:00,131874,17145,20953,16015,5994,15438,207419
2020-10-30,17:30:00,134811,17503,21766,17313,6109,17386,214888
2020-10-30,18:00:00,135278,16637,20929,16530,6298,16569,212241
2020-10-30,18:30:00,136359,17605,21298,16330,6400,16609,214601
2020-10-30,19:00:00,133880,17352,20582,15774,6520,15365,209473
2020-10-30,19:30:00,128029,16018,18211,13495,6596,13355,195704
2020-10-30,20:00:00,128823,14348,17884,13206,5543,13050,192854
2020-10-30,20:30:00,125552,14203,16628,12393,5565,12340,186681
2020-10-30,21:00:00,131222,13584,17003,11586,5248,10737,189380
2020-10-30,21:30:00,123039,14275,15807,11327,5106,11420,180974
2020-10-30,22:00:00,121414,12835,13998,10272,4615,10219,173353
2020-10-30,22:30:00,120193,12437,14077,10239,4782,9939,171667
2020-10-30,23:00:00,119906,12656,14185,10407,4527,9475,171156
2020-10-30,23:30:00,118843,11577,14617,10663,3988,9373,169061
2020-10-31,00:00:00,116245,11817,14528,10625,4839,9523,167577
2020-10-31,00:30:00,116728,12193,14529,8933,4183,9922,166488
2020-10-31,01:00:00,112383,11332,12568,7565,3339,8159,155346
2020-10-31,01:30:00,108915,10196,11444,7146,3132,7710,148543
2020-10-31,02:00:00,110260,11012,11784,7283,3197,7905,151441
2020-10-31,02:30:00,104892,14426,11976,7019,2333,7899,148545
2020-10-31,03:00:00,100600,14005,14344,7488,3170,5451,145058
2020-10-31,03:30:00,94276,13686,13186,8168,2877,4653,136846
2020-10-31,04:00:00,91704,12977,9346,8177,3440,3989,129633
2020-10-31,04:30:00,91233,10309,11543,8202,1901,3940,127128
2020-10-31,05:00:00,86914,10767,7963,7491,1988,3919,119042
2020-10-31,05:30:00,85951,10727,8243,8130,2202,3499,118752
2020-10-31,06:00:00,86783,10639,8590,8251,2273,3839,120375
2020-10-31,06:30:00,95046,11626,11196,9229,2151,7702,136950
2020-10-31,07:00:00,96381,9375,10237,8473,1838,7313,133617
2020-10-31,07:30:00,97109,8767,10412,8655,2214,7569,134726
2020-10-31,08:00:00,98222,9676,10999,9139,2397,7778,138211
2020-10-31,08:30:00,103243,10751,12164,10246,3113,9329,148846
2020-10-31,09:00:00,108456,11210,16737,11282,3300,10023,161008
2020-10-31,09:30:00,112203,12664,14199,10790,3639,9956,163451
2020-10-31,10:00:00,115855,12873,14604,11713,3624,10876,169545
2020-10-31,10:30:00,120360,14906,16348,12708,4455,12665,181442
2020-10-31,11:00:00,124030,15415,17355,13653,4493,13609,188555
2020-10-31,11:30:00,124734,15448,18384,14180,5019,13891,191656
2020-10-31,12:00:00,130959,16327,20982,16185,5747,14417,204617
2020-10-31,12:30:00,132948,16565,21116,15873,5552,14907,206961
2020-10-31,13:00:00,132551,16324,18519,14467,5237,14909,202007
2020-10-31,13:30:00,130663,17093,17834,13672,4757,13015,197034
2020-10-31,14:00:00,132278,15596,18656,14802,4748,13220,199300
2020-10-31,14:30:00,132801,16240,20186,15322,5105,13545,203199
2020-10-31,15:00:00,132639,16137,18898,14839,5321,13468,201302
2020-10-31,15:30:00,132654,17008,20681,15295,5972,14953,206563
2020-10-31,16:00:00,133527,16409,20682,15754,5956,15602,207930
2020-10-31,16:30:00,130431,16293,20130,16066,5623,16597,205140
2020-10-31,17:00:00,133814,17530,19894,14935,6726,15404,208303
2020-10-31,17:30:00,133498,17094,20917,15667,5895,15287,208358
2020-10-31,18:00:00,134510,17024,20395,15386,6145,15015,208475
2020-10-31,18:30:00,133781,16164,19851,15095,5665,15024,205580
2020-10-31,19:00:00,134410,14969,20456,13061,5518,13600,202014
2020-10-31,19:30:00,133179,14108,17008,12663,5336,12432,194726
2020-10-31,20:00:00,130869,13502,15410,11923,4988,11982,188674
2020-10-31,20:30:00,127527,13458,15138,10724,4909,11492,183248
2020-10-31,21:00:00,126740,13959,15903,11368,4784,11250,184004
2020-10-31,21:30:00,125509,13678,14780,10727,4482,11143,180319
2020-10-31,22:00:00,126778,13027,14823,10068,4505,10222,179423
2020-10-31,22:30:00,124342,12786,14378,10251,4219,10119,176095
2020-10-31,23:00:00,123792,12328,14361,9780,4602,8866,173729
2020-10-31,23:30:00,122164,12349,13891,9941,4195,9368,171908
2020-11-01,00:00:00,123011,12929,14332,9753,4162,9276,173463
2020-11-01,00:30:00,123622,12110,14558,8933,3489,11874,174586
2020-11-01,01:00:00,117492,13430,14909,7503,3243,8374,164951
2020-11-01,01:30:00,115722,13666,13888,7467,2646,8271,161660
2020-11-01,02:00:00,111787,13561,13743,7539,2512,7613,156755
2020-11-01,02:30:00,108096,14148,13080,7850,2789,5455,151418
2020-11-01,03:00:00,105950,14890,12511,7380,2380,4239,147350
2020-11-01,03:30:00,107736,14599,12312,7542,1608,4156,147953
2020-11-01,04:00:00,102217,14030,11630,7288,1369,3813,140347
2020-11-01,04:30:00,100410,13999,11178,7078,1374,3680,137719
2020-11-01,05:00:00,100480,14505,11213,7491,1511,3991,139191
2020-11-01,05:30:00,101198,11852,8697,8654,1972,4541,136914
2020-11-01,06:00:00,100590,11615,7970,8433,2410,5178,136196
2020-11-01,06:30:00,99939,11735,11251,9588,2143,7947,142603
2020-11-01,07:00:00,97827,10271,10982,8917,1807,7684,137488
2020-11-01,07:30:00,97786,9915,11052,9248,1930,6957,136888
2020-11-01,08:00:00,101572,9211,11740,9853,2098,8018,142492
2020-11-01,08:30:00,105939,10370,12411,10117,3010,8591,150438
2020-11-01,09:00:00,108541,11467,16737,10120,2616,13752,163233
2020-11-01,09:30:00,113385,11966,14162,11453,4745,9167,164878
2020-11-01,10:00:00,119375,13736,14699,10991,3788,13271,175860
2020-11-01,10:30:00,121977,13495,16017,13100,4495,13501,182585
2020-11-01,11:00:00,124608,15178,18206,12861,4981,13672,189506
2020-11-01,11:30:00,130070,16677,19653,15092,5706,13312,200510
2020-11-01,12:00:00,134641,17176,19387,14718,5043,12449,203414
2020-11-01,12:30:00,135393,16967,19759,14615,6042,14767,207543
2020-11-01,13:00:00,133854,17249,20282,15205,5927,14909,207426
2020-11-01,13:30:00,131614,15967,19119,13201,5541,11049,196491
2020-11-01,14:00:00,130642,14760,17401,12662,4930,13941,194336
2020-11-01,14:30:00,132191,14817,16952,13916,5572,13959,197407
2020-11-01,15:00:00,133548,16271,18872,12559,5895,13785,200930
2020-11-01,15:30:00,133101,14207,18007,12917,5151,14167,197550
2020-11-01,16:00:00,136464,14546,18793,12482,5774,14450,202509
2020-11-01,16:30:00,136392,15354,18239,12406,5921,15023,203335
2020-11-01,17:00:00,137864,16458,18198,15264,6289,15495,209568
2020-11-01,17:30:00,137507,15875,18704,13597,6990,16348,209021
2020-11-01,18:00:00,134853,15770,21205,16773,6716,16873,212190
2020-11-01,18:30:00,135863,15671,21576,16975,5559,17100,212744
2020-11-01,19:00:00,133329,14834,20456,15996,5464,11683,201762
2020-11-01,19:30:00,135844,15050,15910,11996,5787,11765,196352
2020-11-01,20:00:00,134542,15471,16545,10918,6182,10408,194066
2020-11-01,20:30:00,137592,15195,16505,11165,5449,10483,196389
2020-11-01,21:00:00,132268,14421,16637,11148,5297,10633,190404
2020-11-01,21:30:00,132745,16250,17131,10788,5970,11836,194720
2020-11-01,22:00:00,131038,15822,15472,10428,4962,10835,188557
2020-11-01,22:30:00,127595,14305,14204,9131,4403,9775,179413
2020-11-01,23:00:00,126912,14657,15306,9995,4814,10491,182175
2020-11-01,23:30:00,125437,13537,14934,9866,3987,10419,178180
2020-11-02,00:00:00,120170,13153,14630,9373,4299,10093,171718
2020-11-02,00:30:00,122615,13421,14540,8417,4713,10721,174427
2020-11-02,01:00:00,120645,11525,13349,6939,2543,10988,165989
2020-11-02,01:30:00,116070,11177,14089,7561,2131,11151,162179
2020-11-02,02:00:00,111885,12661,14078,7297,2219,8476,156616
2020-11-02,02:30:00,103525,14891,13980,7508,2876,8657,151437
2020-11-02,03:00:00,98870,15973,13507,7117,1481,7231,144179
2020-11-02,03:30:00,93843,14905,11924,7138,1334,3796,132940
2020-11-02,04:00:00,93810,14629,13090,7639,1476,4198,134842
2020-11-02,04:30:00,94322,14663,12051,6838,1366,3698,132938
2020-11-02,05:00:00,92813,15442,12774,7448,1634,3813,133924
2020-11-02,05:30:00,92554,10791,11708,7406,1820,3674,127953
2020-11-02,06:00:00,91736,13791,9543,8841,2420,4693,131024
2020-11-02,06:30:00,105909,11454,14111,9455,2643,9904,153476
2020-11-02,07:00:00,108575,12053,13267,9905,2644,8398,154842
2020-11-02,07:30:00,117621,12932,15674,11620,3474,9970,171291
2020-11-02,08:00:00,126772,13251,15630,13288,3484,11349,183774
2020-11-02,08:30:00,131554,14608,14812,13831,2997,12542,190344
2020-11-02,09:00:00,135090,16169,18988,15099,3850,14264,203460
2020-11-02,09:30:00,138627,17731,20639,16367,4704,15986,214054
2020-11-02,10:00:00,139353,16840,18457,13657,5422,13235,206964
2020-11-02,10:30:00,137408,16643,18455,12990,6345,13491,205332
2020-11-02,11:00:00,136433,16506,18239,12935,6510,13512,204135
2020-11-02,11:30:00,133267,16610,18558,13565,6056,14363,202419
2020-11-02,12:00:00,137801,16621,18611,13575,6263,13600,206471
2020-11-02,12:30:00,139956,16640,18873,14643,6120,14581,210813
2020-11-02,13:00:00,138946,17161,19290,14762,5958,14950,211067
2020-11-02,13:30:00,140087,17367,18906,13366,5635,13278,208639
2020-11-02,14:00:00,138753,17256,18935,12891,6302,13274,207411
2020-11-02,14:30:00,138022,17737,18797,12920,5721,12671,205868
2020-11-02,15:00:00,136849,16924,19079,13411,5447,12694,204404
2020-11-02,15:30:00,136567,17940,18445,12026,5793,14167,204938
2020-11-02,16:00:00,137457,16030,17844,12137,5461,14450,203379
2020-11-02,16:30:00,136790,17390,19443,13508,5689,14307,207127
2020-11-02,17:00:00,140482,17662,21217,15452,6353,17093,218259
2020-11-02,17:30:00,143320,18742,21476,16318,6570,17296,223722
2020-11-02,18:00:00,143966,19172,22506,17475,6799,16951,226869
2020-11-02,18:30:00,147178,17411,22611,17483,7506,17364,229553
2020-11-02,19:00:00,147030,19592,21172,16080,7174,15569,226617
2020-11-02,19:30:00,142148,18024,21182,15154,6809,15856,219173
2020-11-02,20:00:00,137754,17417,17992,12629,6009,12414,204215
2020-11-02,20:30:00,135022,16338,16665,11603,5355,10999,195982
2020-11-02,21:00:00,133458,16735,17000,11780,5318,10988,195279
2020-11-02,21:30:00,133533,16688,17103,11219,5453,10773,194769
2020-11-02,22:00:00,132844,16293,16266,10915,5016,10347,191681
2020-11-02,22:30:00,128259,15356,16918,10933,4669,9983,186118
2020-11-02,23:00:00,126913,15442,15395,9837,4302,9666,181555
2020-11-02,23:30:00,123400,14658,14350,9052,4062,10036,175558
2020-11-03,00:00:00,122576,12900,15011,9823,3708,10813,174831
2020-11-03,00:30:00,120698,13283,14583,8679,3213,10806,171262
2020-11-03,01:00:00,113298,11411,12362,7638,2498,10961,158168
2020-11-03,01:30:00,112018,12358,12629,7756,1735,9849,156345
2020-11-03,02:00:00,111185,13334,12551,7127,2170,9539,155906
2020-11-03,02:30:00,111521,16421,14278,6892,3098,6629,158839
2020-11-03,03:00:00,110981,15411,14177,7020,2645,7746,157980
2020-11-03,03:30:00,103915,14607,12709,7076,1885,4449,144641
2020-11-03,04:00:00,100503,14096,14279,6863,2151,4533,142425
2020-11-03,04:30:00,95185,10206,14787,7105,2110,4294,133687
2020-11-03,05:00:00,96846,10245,15341,7787,2083,4400,136702
2020-11-03,05:30:00,97058,10671,15574,7577,1981,4501,137362
2020-11-03,06:00:00,96517,9949,9338,7790,2456,4666,130716
2020-11-03,06:30:00,106240,11674,14000,9795,2289,9079,153077
2020-11-03,07:00:00,110270,11568,13178,9855,2609,8979,156459
2020-11-03,07:30:00,116398,13852,14914,11788,2938,10089,169979
2020-11-03,08:00:00,125343,13788,16230,13027,4280,12038,184706
2020-11-03,08:30:00,131316,14785,14812,13684,4673,13973,193243
2020-11-03,09:00:00,137041,17990,16737,14895,5732,16916,209311
2020-11-03,09:30:00,139085,18510,20764,15110,4745,16733,214947
2020-11-03,10:00:00,136596,16930,18363,13376,5562,15698,206525
2020-11-03,10:30:00,136474,17527,18419,13146,5580,15299,206445
2020-11-03,11:00:00,132664,17232,20035,13785,6103,14351,204170
2020-11-03,11:30:00,132226,17208,18079,12727,5596,14125,199961
2020-11-03,12:00:00,136467,16869,20174,13636,6522,14648,208316
2020-11-03,12:30:00,140503,16760,20793,14603,6377,15405,214441
2020-11-03,13:00:00,137914,17188,20456,15207,5838,15116,211719
2020-11-03,13:30:00,135978,17344,19727,14523,5956,14539,208067
2020-11-03,14:00:00,137971,18274,19276,14015,6152,14795,210483
2020-11-03,14:30:00,135197,16875,19584,14622,5315,14943,206536
2020-11-03,15:00:00,136115,17567,18918,13964,5221,14446,206231
2020-11-03,15:30:00,138103,16827,19668,13764,5773,14365,208500
2020-11-03,16:00:00,136979,16949,20658,14124,6659,14816,210185
2020-11-03,16:30:00,140477,18286,20664,15117,6594,14858,215996
2020-11-03,17:00:00,141295,18156,22729,15264,6337,16814,220595
2020-11-03,17:30:00,143472,19131,21639,16420,7154,16869,224685
2020-11-03,18:00:00,144457,18447,22011,17178,7149,16777,226019
2020-11-03,18:30:00,145060,16845,21410,16769,6653,17828,224565
2020-11-03,19:00:00,141329,18099,22187,17155,6683,16928,222381
2020-11-03,19:30:00,140641,17970,20054,14262,6636,14500,214063
2020-11-03,20:00:00,139504,16506,17993,13346,5788,12481,205618
2020-11-03,20:30:00,134094,15662,18071,12727,5919,11938,198411
2020-11-03,21:00:00,132670,14351,16326,11739,5188,11233,191507
2020-11-03,21:30:00,132358,14907,16252,11265,5192,11345,191319
2020-11-03,22:00:00,131124,15902,15284,9745,5059,10485,187599
2020-11-03,22:30:00,127264,15476,14914,9947,5211,10156,182968
2020-11-03,23:00:00,128847,14040,15260,9959,4501,11069,183676
2020-11-03,23:30:00,126677,13754,14501,9893,3536,11353,179714
2020-11-04,00:00:00,122025,12972,14094,10147,3045,11013,173296
2020-11-04,00:30:00,119258,13641,14877,9124,4071,10245,171216
2020-11-04,01:00:00,115759,15181,14347,7604,3918,9171,165980
2020-11-04,01:30:00,113989,15106,15614,7798,3644,8206,164357
2020-11-04,02:00:00,110102,15590,14744,7257,3468,7946,159107
2020-11-04,02:30:00,105901,15514,13198,6631,2608,7819,151671
2020-11-04,03:00:00,104898,15330,14070,7449,2833,6572,151152
2020-11-04,03:30:00,103783,14683,13400,7447,2572,5159,147044
2020-11-04,04:00:00,102139,15358,14018,7903,1610,4979,146007
2020-11-04,04:30:00,98691,15036,13250,7482,1771,4581,140811
2020-11-04,05:00:00,97711,15978,13518,7527,1506,4381,140621
2020-11-04,05:30:00,96032,10791,13511,8003,1741,4833,134911
2020-11-04,06:00:00,97716,11779,8886,8280,1918,5158,133737
2020-11-04,06:30:00,108785,11454,12412,9600,2061,9691,154003
2020-11-04,07:00:00,109716,11704,11473,9118,2650,8217,152878
2020-11-04,07:30:00,116672,12644,13610,10787,2923,10890,167526
2020-11-04,08:00:00,127692,14627,15621,12792,3867,12587,187186
2020-11-04,08:30:00,129493,13936,15005,11956,4181,13318,187889
2020-11-04,09:00:00,137634,16724,17470,13472,5015,15040,205355
2020-11-04,09:30:00,133865,16899,18873,13591,4824,15263,203315
2020-11-04,10:00:00,134731,17236,19120,13357,5367,15120,204931
2020-11-04,10:30:00,135770,18561,20228,13100,5703,14793,208155
2020-11-04,11:00:00,137789,17255,19329,13442,5612,13796,207223
2020-11-04,11:30:00,137249,17919,19827,14660,5267,14083,209005
2020-11-04,12:00:00,136346,16869,21937,15047,6655,15135,211989
2020-11-04,12:30:00,140479,18130,21661,15524,6115,15325,217234
2020-11-04,13:00:00,141244,17188,21835,15407,6456,14999,217129
2020-11-04,13:30:00,143055,16904,19326,14806,6353,15193,215637
2020-11-04,14:00:00,140629,16731,18975,14925,6453,14757,212470
2020-11-04,14:30:00,140158,18022,21154,14277,5502,14565,213678
2020-11-04,15:00:00,136714,18122,18872,14743,6138,13856,208445
2020-11-04,15:30:00,137377,18398,20769,14829,5564,14777,211714
2020-11-04,16:00:00,136526,16116,21546,14909,6655,15334,211086
2020-11-04,16:30:00,135695,17697,20517,15834,6346,15841,211930
2020-11-04,17:00:00,136451,19122,21869,15856,7023,16911,217232
2020-11-04,17:30:00,140746,19422,23279,17330,7098,17895,225770
2020-11-04,18:00:00,144849,19735,21205,18318,6942,18839,229888
2020-11-04,18:30:00,149129,17411,24678,18601,7142,18107,235068
2020-11-04,19:00:00,147153,18136,21890,16348,6763,16407,226697
2020-11-04,19:30:00,143449,17464,20010,14914,5881,15145,216863
2020-11-04,20:00:00,141370,17436,19796,14058,5752,13537,211949
2020-11-04,20:30:00,136268,15550,17651,12988,5804,12245,200506
2020-11-04,21:00:00,133930,15615,17003,12357,5683,11147,195735
2020-11-04,21:30:00,133185,15202,18054,12558,5878,11029,195906
2020-11-04,22:00:00,130355,14192,17026,11415,4886,9862,187736
2020-11-04,22:30:00,131729,15233,17023,11529,4751,10196,190461
2020-11-04,23:00:00,127616,14404,16081,11024,5296,10317,184738
2020-11-04,23:30:00,127044,14108,14204,10776,4253,11055,181440
